Child's First Name,Year of Birth,Gender,ASIAN AND PACIFIC ISLANDER,BLACK NON HISPANIC,HISPANIC,WHITE NON HISPANIC,overall_count,rank
AALIYAH,2011,FEMALE,0,4968,4536,0,9504,72.0
ABBY,2011,FEMALE,0,0,360,0,360,587.0
ABIGAIL,2011,FEMALE,3456,7344,11520,14832,37152,13.0
ADA,2011,FEMALE,468,0,0,0,468,474.0
ADDISON,2011,FEMALE,0,936,0,1368,2304,195.0
ADELE,2011,FEMALE,0,0,0,792,792,323.0
ADELINE,2011,FEMALE,0,0,0,432,432,508.0
ADINA,2011,FEMALE,0,0,0,684,684,361.0
ADRIANA,2011,FEMALE,0,0,4680,2088,6768,88.0
ADRIANNA,2011,FEMALE,0,0,1872,1296,3168,168.0
AHUVA,2011,FEMALE,0,0,0,576,576,394.0
AICHA,2011,FEMALE,0,504,0,0,504,442.0
AILEEN,2011,FEMALE,0,0,756,0,756,337.0
AIMEE,2011,FEMALE,0,0,432,0,432,508.0
AISHA,2011,FEMALE,1404,1080,1404,0,3888,143.0
AISSATOU,2011,FEMALE,0,468,0,0,468,474.0
AIZA,2011,FEMALE,360,0,0,0,360,587.0
ALANA,2011,FEMALE,0,1296,792,0,2088,211.0
ALEENA,2011,FEMALE,432,0,0,0,432,508.0
ALEJANDRA,2011,FEMALE,0,0,576,0,576,394.0
ALESSANDRA,2011,FEMALE,0,0,936,1440,2376,191.0
ALESSIA,2011,FEMALE,0,0,0,504,504,442.0
ALEXA,2011,FEMALE,1080,0,5940,5832,12852,51.0
ALEXANDRA,2011,FEMALE,1404,0,5076,11772,18252,35.0
ALEXIS,2011,FEMALE,0,936,0,1944,2880,172.0
ALICE,2011,FEMALE,2916,0,1728,5400,10044,68.0
ALICIA,2011,FEMALE,0,1188,2592,1188,4968,115.0
ALINA,2011,FEMALE,1800,0,0,792,2592,182.0
ALISA,2011,FEMALE,0,0,0,504,504,442.0
ALISHA,2011,FEMALE,360,0,0,0,360,587.0
ALISON,2011,FEMALE,0,0,1152,0,1152,268.0
ALISSON,2011,FEMALE,0,0,540,0,540,417.0
ALIYAH,2011,FEMALE,1296,2484,2376,0,6156,95.0
ALIZA,2011,FEMALE,0,0,0,792,792,323.0
ALLISON,2011,FEMALE,1836,0,9720,1620,13176,49.0
ALLYSON,2011,FEMALE,0,0,684,0,684,361.0
ALONDRA,2011,FEMALE,0,0,576,0,576,394.0
ALYSON,2011,FEMALE,0,0,396,0,396,546.0
ALYSSA,2011,FEMALE,3744,5040,9072,4032,21888,29.0
AMANDA,2011,FEMALE,3168,2448,4320,2160,12096,56.0
AMANI,2011,FEMALE,0,540,0,0,540,417.0
AMAYA,2011,FEMALE,0,2304,2232,0,4536,126.0
AMBER,2011,FEMALE,1404,1944,2700,0,6048,96.0
AMELIA,2011,FEMALE,2016,2736,4752,8928,18432,34.0
AMELIE,2011,FEMALE,0,0,0,540,540,417.0
AMINA,2011,FEMALE,0,1008,0,1224,2232,200.0
AMINATA,2011,FEMALE,0,900,0,0,900,298.0
AMIRA,2011,FEMALE,0,1080,0,792,1872,224.0
AMIRAH,2011,FEMALE,0,792,0,0,792,323.0
AMIYAH,2011,FEMALE,0,720,0,0,720,344.0
AMY,2011,FEMALE,2592,0,9396,1188,13176,49.0
ANA,2011,FEMALE,0,0,1188,0,1188,262.0
ANALIA,2011,FEMALE,0,0,612,0,612,379.0
ANASTASIA,2011,FEMALE,0,0,0,684,684,361.0
ANAYA,2011,FEMALE,0,864,792,0,1656,237.0
ANDREA,2011,FEMALE,0,0,2196,0,2196,205.0
ANGEL,2011,FEMALE,1584,1152,0,0,2736,179.0
ANGELA,2011,FEMALE,3384,0,1440,0,4824,119.0
ANGELICA,2011,FEMALE,0,0,2880,720,3600,151.0
ANGELINA,2011,FEMALE,3744,1584,10368,7200,22896,26.0
ANGELIQUE,2011,FEMALE,0,0,1080,0,1080,273.0
ANGELY,2011,FEMALE,0,0,396,0,396,546.0
ANGIE,2011,FEMALE,720,0,1368,0,2088,211.0
ANIKA,2011,FEMALE,504,0,0,0,504,442.0
ANIYA,2011,FEMALE,0,684,0,0,684,361.0
ANIYAH,2011,FEMALE,0,2520,1008,0,3528,154.0
ANNA,2011,FEMALE,3240,0,1404,9180,13824,47.0
ANNABEL,2011,FEMALE,0,0,0,504,504,442.0
ANNABELLE,2011,FEMALE,1080,0,1404,2916,5400,107.0
ANNIE,2011,FEMALE,720,0,0,0,720,344.0
APRIL,2011,FEMALE,0,0,468,0,468,474.0
ARELY,2011,FEMALE,0,0,432,0,432,508.0
ARIA,2011,FEMALE,864,936,0,0,1800,230.0
ARIANA,2011,FEMALE,2160,1872,8784,3888,16704,40.0
ARIANNA,2011,FEMALE,1584,5472,11088,4032,22176,28.0
ARIANNY,2011,FEMALE,0,0,360,0,360,587.0
ARIEL,2011,FEMALE,0,3456,1836,1512,6804,87.0
ARIELA,2011,FEMALE,0,0,0,360,360,587.0
ARIELLA,2011,FEMALE,0,0,1008,1872,2880,172.0
ARIELLE,2011,FEMALE,0,720,0,0,720,344.0
ARYA,2011,FEMALE,432,0,0,0,432,508.0
ASHLEY,2011,FEMALE,7488,2304,27360,2880,40032,12.0
ASHLY,2011,FEMALE,0,0,468,0,468,474.0
ATARA,2011,FEMALE,0,0,0,360,360,587.0
ATHENA,2011,FEMALE,0,0,432,0,432,508.0
AUBREY,2011,FEMALE,0,1728,2700,1080,5508,106.0
AUDREY,2011,FEMALE,1368,0,0,1872,3240,166.0
AURORA,2011,FEMALE,0,0,576,0,576,394.0
AUTUMN,2011,FEMALE,0,1872,0,720,2592,182.0
AVA,2011,FEMALE,3312,5760,7776,23328,40176,11.0
AVERY,2011,FEMALE,0,0,0,1872,1872,224.0
AVIGAIL,2011,FEMALE,0,0,0,396,396,546.0
AVIVA,2011,FEMALE,0,0,0,648,648,371.0
AYESHA,2011,FEMALE,612,0,0,0,612,379.0
AYLA,2011,FEMALE,0,0,0,360,360,587.0
AYLEEN,2011,FEMALE,0,0,504,0,504,442.0
AYLIN,2011,FEMALE,0,0,576,0,576,394.0
BAILA,2011,FEMALE,0,0,0,1440,1440,249.0
BARBARA,2011,FEMALE,0,0,0,432,432,508.0
BATSHEVA,2011,FEMALE,0,0,0,720,720,344.0
BATYA,2011,FEMALE,0,0,0,540,540,417.0
BEATRICE,2011,FEMALE,0,0,0,1188,1188,262.0
BELLA,2011,FEMALE,1728,0,7236,2376,11340,61.0
BIANCA,2011,FEMALE,0,0,1728,720,2448,190.0
BLAKE,2011,FEMALE,0,0,0,504,504,442.0
BLIMA,2011,FEMALE,0,0,0,720,720,344.0
BLIMY,2011,FEMALE,0,0,0,828,828,315.0
BONNIE,2011,FEMALE,360,0,0,0,360,587.0
BRACHA,2011,FEMALE,0,0,0,864,864,309.0
BREINDY,2011,FEMALE,0,0,0,540,540,417.0
BRENDA,2011,FEMALE,0,0,612,0,612,379.0
BRIANA,2011,FEMALE,0,0,1152,0,1152,268.0
BRIANNA,2011,FEMALE,1872,5472,16416,4608,28368,20.0
BRIANNY,2011,FEMALE,0,0,360,0,360,587.0
BRIDGET,2011,FEMALE,0,0,0,504,504,442.0
BRIELLE,2011,FEMALE,0,2520,792,0,3312,162.0
BRITNEY,2011,FEMALE,0,0,432,0,432,508.0
BRITTANY,2011,FEMALE,0,0,792,0,792,323.0
BROOKE,2011,FEMALE,0,864,0,2376,3240,166.0
BROOKLYN,2011,FEMALE,0,0,0,540,540,417.0
BRUCHA,2011,FEMALE,0,0,0,684,684,361.0
BRUCHY,2011,FEMALE,0,0,0,468,468,474.0
BRYANNA,2011,FEMALE,0,0,576,0,576,394.0
BRYNN,2011,FEMALE,0,0,0,504,504,442.0
CAITLIN,2011,FEMALE,0,0,0,396,396,546.0
CAMERON,2011,FEMALE,0,0,0,396,396,546.0
CAMILA,2011,FEMALE,0,0,6768,0,6768,88.0
CAMILLE,2011,FEMALE,0,432,0,0,432,508.0
CARMEN,2011,FEMALE,0,0,432,0,432,508.0
CAROLINA,2011,FEMALE,0,0,396,0,396,546.0
CAROLINE,2011,FEMALE,0,0,864,3744,4608,122.0
CASEY,2011,FEMALE,0,0,0,432,432,508.0
CASSANDRA,2011,FEMALE,0,0,360,0,360,587.0
CATHERINE,2011,FEMALE,1944,0,0,2376,4320,134.0
CECILIA,2011,FEMALE,864,0,0,1152,2016,213.0
CELESTE,2011,FEMALE,0,0,396,0,396,546.0
CELIA,2011,FEMALE,0,0,0,360,360,587.0
CHANA,2011,FEMALE,0,0,0,4752,4752,121.0
CHANY,2011,FEMALE,0,0,0,1368,1368,253.0
CHARLIE,2011,FEMALE,0,0,0,504,504,442.0
CHARLOTTE,2011,FEMALE,1512,0,1188,13716,16416,41.0
CHAVA,2011,FEMALE,0,0,0,1656,1656,237.0
CHAVY,2011,FEMALE,0,0,0,360,360,587.0
CHAYA,2011,FEMALE,0,0,0,6408,6408,92.0
CHELSEA,2011,FEMALE,0,2664,3096,0,5760,101.0
CHEYENNE,2011,FEMALE,0,360,0,0,360,587.0
CHLOE,2011,FEMALE,15264,10368,8640,13680,47952,9.0
CHRISTINA,2011,FEMALE,2760,2346,1265,1932,8303,78.0
CHRISTINE,2011,FEMALE,396,0,0,0,396,546.0
CHRISTY,2011,FEMALE,432,0,0,0,432,508.0
CINDY,2011,FEMALE,1008,0,936,0,1944,218.0
CLAIRE,2011,FEMALE,1944,0,0,2520,4464,131.0
CLARA,2011,FEMALE,0,0,792,2016,2808,175.0
COLETTE,2011,FEMALE,0,0,0,504,504,442.0
CORA,2011,FEMALE,0,0,0,360,360,587.0
CRISTINA,2011,FEMALE,0,0,360,0,360,587.0
CRYSTAL,2011,FEMALE,0,0,936,0,936,287.0
CYNTHIA,2011,FEMALE,1008,0,720,0,1728,234.0
DAHLIA,2011,FEMALE,0,0,0,540,540,417.0
DAISY,2011,FEMALE,1188,0,3240,1404,5832,98.0
DAKOTA,2011,FEMALE,0,540,0,0,540,417.0
DALIA,2011,FEMALE,0,0,0,360,360,587.0
DAMARIS,2011,FEMALE,0,0,396,0,396,546.0
DANA,2011,FEMALE,0,0,648,0,648,371.0
DANIELA,2011,FEMALE,0,0,4608,936,5544,104.0
DANIELLA,2011,FEMALE,0,0,2016,2952,4968,115.0
DANIELLE,2011,FEMALE,0,2040,1020,1530,4590,125.0
DANNA,2011,FEMALE,0,0,1404,0,1404,250.0
DAYANA,2011,FEMALE,0,0,792,0,792,323.0
DELILAH,2011,FEMALE,0,0,1044,0,1044,277.0
DENISE,2011,FEMALE,0,0,576,0,576,394.0
DESTINY,2011,FEMALE,0,2520,2448,0,4968,115.0
DEVORA,2011,FEMALE,0,0,0,612,612,379.0
DEVORAH,2011,FEMALE,0,0,0,1584,1584,243.0
DIANA,2011,FEMALE,0,0,3672,936,4608,122.0
DINA,2011,FEMALE,0,0,0,1476,1476,247.0
DIYA,2011,FEMALE,432,0,0,0,432,508.0
DULCE,2011,FEMALE,0,0,720,0,720,344.0
DYLAN,2011,FEMALE,0,792,0,1440,2232,200.0
EDEN,2011,FEMALE,0,792,0,1728,2520,188.0
EGYPT,2011,FEMALE,0,540,0,0,540,417.0
EILEEN,2011,FEMALE,1296,0,1008,0,2304,195.0
ELAINE,2011,FEMALE,1008,0,0,0,1008,280.0
ELEANOR,2011,FEMALE,0,0,0,1404,1404,250.0
ELENA,2011,FEMALE,1224,0,1360,1938,4522,130.0
ELIANA,2011,FEMALE,0,0,2448,2592,5040,114.0
ELIANNA,2011,FEMALE,0,0,396,0,396,546.0
ELIANNY,2011,FEMALE,0,0,432,0,432,508.0
ELINA,2011,FEMALE,396,0,0,0,396,546.0
ELISA,2011,FEMALE,0,0,612,0,612,379.0
ELISE,2011,FEMALE,0,0,0,468,468,474.0
ELISHEVA,2011,FEMALE,0,0,0,504,504,442.0
ELIZA,2011,FEMALE,0,0,0,900,900,298.0
ELIZABETH,2011,FEMALE,2070,2530,8694,13800,27094,23.0
ELLA,2011,FEMALE,2700,0,3456,13716,19872,33.0
ELLE,2011,FEMALE,0,0,0,612,612,379.0
ELLIANA,2011,FEMALE,0,0,0,396,396,546.0
ELLIE,2011,FEMALE,0,0,0,936,936,287.0
ELOISE,2011,FEMALE,0,0,0,864,864,309.0
EMELY,2011,FEMALE,0,0,1800,0,1800,230.0
EMERSON,2011,FEMALE,0,0,0,576,576,394.0
EMILIA,2011,FEMALE,0,0,0,1188,1188,262.0
EMILY,2011,FEMALE,13392,4320,23328,17136,58176,6.0
EMMA,2011,FEMALE,10800,2160,16416,30672,60048,4.0
ERICA,2011,FEMALE,684,0,0,0,684,361.0
ERIKA,2011,FEMALE,864,0,1080,0,1944,218.0
ERIN,2011,FEMALE,1404,1080,0,1620,4104,138.0
ESHAL,2011,FEMALE,396,0,0,0,396,546.0
ESMERALDA,2011,FEMALE,0,0,972,0,972,283.0
ESSENCE,2011,FEMALE,0,396,0,0,396,546.0
ESTER,2011,FEMALE,0,0,0,504,504,442.0
ESTHER,2011,FEMALE,0,0,1008,16128,17136,38.0
ESTRELLA,2011,FEMALE,0,0,540,0,540,417.0
ESTY,2011,FEMALE,0,0,0,648,648,371.0
ETTY,2011,FEMALE,0,0,0,540,540,417.0
EVA,2011,FEMALE,3168,1584,6768,9216,20736,30.0
EVE,2011,FEMALE,0,0,0,792,792,323.0
EVELYN,2011,FEMALE,1836,0,6804,4212,12852,51.0
FAIGA,2011,FEMALE,0,0,0,576,576,394.0
FAIGY,2011,FEMALE,0,0,0,2592,2592,182.0
FAITH,2011,FEMALE,0,3312,1800,0,5112,112.0
FANTA,2011,FEMALE,0,540,0,0,540,417.0
FATIMA,2011,FEMALE,2592,2592,1296,0,6480,91.0
FATOU,2011,FEMALE,0,432,0,0,432,508.0
FATOUMATA,2011,FEMALE,0,1836,0,0,1836,227.0
FERNANDA,2011,FEMALE,0,0,504,0,504,442.0
FINLEY,2011,FEMALE,0,0,0,396,396,546.0
FIONA,2011,FEMALE,3456,0,0,2160,5616,102.0
FRADEL,2011,FEMALE,0,0,0,576,576,394.0
FRAIDY,2011,FEMALE,0,0,0,936,936,287.0
FRANCESCA,2011,FEMALE,0,0,0,1188,1188,262.0
FRIMET,2011,FEMALE,0,0,0,360,360,587.0
GABRIELA,2011,FEMALE,0,0,5616,1368,6984,85.0
GABRIELLA,2011,FEMALE,0,2592,9288,11016,22896,26.0
GABRIELLE,2011,FEMALE,0,5940,1512,1620,9072,73.0
GEMMA,2011,FEMALE,0,0,0,540,540,417.0
GENESIS,2011,FEMALE,0,1080,6768,0,7848,80.0
GENEVIEVE,2011,FEMALE,0,0,0,432,432,508.0
GEORGIA,2011,FEMALE,0,0,0,936,936,287.0
GERALDINE,2011,FEMALE,0,0,468,0,468,474.0
GIA,2011,FEMALE,0,0,1512,1872,3384,160.0
GIANNA,2011,FEMALE,1404,0,5292,7344,14040,45.0
GIOVANNA,2011,FEMALE,0,0,0,360,360,587.0
GISELLE,2011,FEMALE,0,0,1368,0,1368,253.0
GITTEL,2011,FEMALE,0,0,0,828,828,315.0
GITTY,2011,FEMALE,0,0,0,2952,2952,170.0
GIULIANA,2011,FEMALE,0,0,0,1476,1476,247.0
GOLDA,2011,FEMALE,0,0,0,504,504,442.0
GOLDY,2011,FEMALE,0,0,0,1188,1188,262.0
GRACE,2011,FEMALE,4752,2160,5184,13392,25488,24.0
GRETA,2011,FEMALE,0,0,0,432,432,508.0
GUADALUPE,2011,FEMALE,0,0,936,0,936,287.0
HADASSA,2011,FEMALE,0,0,0,396,396,546.0
HADASSAH,2011,FEMALE,0,0,0,540,540,417.0
HAILEY,2011,FEMALE,2304,4464,18144,4896,29808,18.0
HALEY,2011,FEMALE,0,0,504,0,504,442.0
HANNA,2011,FEMALE,0,0,0,396,396,546.0
HANNAH,2011,FEMALE,3174,2760,2346,9798,18078,36.0
HARMONY,2011,FEMALE,0,720,0,0,720,344.0
HARPER,2011,FEMALE,0,0,0,1080,1080,273.0
HAWA,2011,FEMALE,0,540,0,0,540,417.0
HAYLEE,2011,FEMALE,0,0,612,0,612,379.0
HAYLEY,2011,FEMALE,0,0,468,0,468,474.0
HAZEL,2011,FEMALE,0,0,720,1296,2016,213.0
HEAVEN,2011,FEMALE,0,2304,1080,0,3384,160.0
HEIDI,2011,FEMALE,0,0,540,0,540,417.0
HEIDY,2011,FEMALE,0,0,576,0,576,394.0
HELEN,2011,FEMALE,720,0,936,0,1656,237.0
HENNY,2011,FEMALE,0,0,0,648,648,371.0
HINDY,2011,FEMALE,0,0,0,1332,1332,257.0
IDY,2011,FEMALE,0,0,0,360,360,587.0
ILANA,2011,FEMALE,0,0,0,360,360,587.0
IMANI,2011,FEMALE,0,2016,792,0,2808,175.0
INGRID,2011,FEMALE,0,0,396,0,396,546.0
IRENE,2011,FEMALE,1440,0,792,0,2232,200.0
IRIS,2011,FEMALE,2652,0,1020,1105,4777,120.0
ISABEL,2011,FEMALE,1296,0,3024,3672,7992,79.0
ISABELA,2011,FEMALE,0,0,360,0,360,587.0
ISABELLA,2011,FEMALE,9648,5040,47664,23040,85392,1.0
ISABELLE,2011,FEMALE,1188,0,1944,2700,5832,98.0
ISIS,2011,FEMALE,0,0,468,0,468,474.0
ISLA,2011,FEMALE,0,0,0,504,504,442.0
ITZEL,2011,FEMALE,0,0,972,0,972,283.0
IVY,2011,FEMALE,2520,0,0,1080,3600,151.0
IZABELLA,2011,FEMALE,0,0,1656,720,2376,191.0
JACQUELINE,2011,FEMALE,0,0,2160,1440,3600,151.0
JADA,2011,FEMALE,0,3744,1512,0,5256,110.0
JADE,2011,FEMALE,0,1296,3600,0,4896,118.0
JAELYNN,2011,FEMALE,0,0,396,0,396,546.0
JALIYAH,2011,FEMALE,0,360,0,0,360,587.0
JAMIE,2011,FEMALE,0,0,396,0,396,546.0
JANE,2011,FEMALE,0,0,0,972,972,283.0
JANELLE,2011,FEMALE,0,792,864,0,1656,237.0
JANICE,2011,FEMALE,504,0,0,0,504,442.0
JANIYA,2011,FEMALE,0,468,0,0,468,474.0
JANIYAH,2011,FEMALE,0,432,0,0,432,508.0
JANNAT,2011,FEMALE,468,0,0,0,468,474.0
JASLENE,2011,FEMALE,0,0,396,0,396,546.0
JASMIN,2011,FEMALE,0,0,720,0,720,344.0
JASMINE,2011,FEMALE,4464,4608,5904,2016,16992,39.0
JAYDA,2011,FEMALE,0,1152,720,0,1872,224.0
JAYLA,2011,FEMALE,0,2736,2376,0,5112,112.0
JAYLAH,2011,FEMALE,0,0,432,0,432,508.0
JAYLEEN,2011,FEMALE,0,0,1836,0,1836,227.0
JAYLENE,2011,FEMALE,0,0,792,0,792,323.0
JAYLIN,2011,FEMALE,0,0,468,0,468,474.0
JAYLYN,2011,FEMALE,0,0,360,0,360,587.0
JAZLYN,2011,FEMALE,0,0,576,0,576,394.0
JAZMIN,2011,FEMALE,0,0,864,0,864,309.0
JAZMINE,2011,FEMALE,0,0,504,0,504,442.0
JENNA,2011,FEMALE,0,0,0,792,792,323.0
JENNIFER,2011,FEMALE,1296,0,4248,0,5544,104.0
JENNY,2011,FEMALE,972,0,0,0,972,283.0
JESSICA,2011,FEMALE,2808,0,4968,2376,10152,67.0
JESSIE,2011,FEMALE,648,0,0,0,648,371.0
JIA,2011,FEMALE,432,0,0,0,432,508.0
JIMENA,2011,FEMALE,0,0,396,0,396,546.0
JOANNA,2011,FEMALE,1368,0,0,0,1368,253.0
JOCELYN,2011,FEMALE,1080,0,3312,0,4392,132.0
JOHANNA,2011,FEMALE,0,0,432,0,432,508.0
JORDYN,2011,FEMALE,0,1152,0,792,1944,218.0
JOSELYN,2011,FEMALE,0,0,1080,0,1080,273.0
JOSEPHINE,2011,FEMALE,0,0,0,1188,1188,262.0
JOY,2011,FEMALE,504,0,0,0,504,442.0
JOYCE,2011,FEMALE,1584,0,0,1008,2592,182.0
JULIA,2011,FEMALE,3456,1440,3168,16704,24768,25.0
JULIANA,2011,FEMALE,0,0,1152,2736,3888,143.0
JULIANNA,2011,FEMALE,0,0,1512,2016,3528,154.0
JULIE,2011,FEMALE,0,0,0,360,360,587.0
JULIET,2011,FEMALE,0,0,1440,2592,4032,141.0
JULIETTE,2011,FEMALE,0,0,1080,1656,2736,179.0
JULISSA,2011,FEMALE,0,0,576,0,576,394.0
KAELYN,2011,FEMALE,0,0,396,0,396,546.0
KAI,2011,FEMALE,0,360,0,0,360,587.0
KAILEY,2011,FEMALE,0,0,720,0,720,344.0
KAILYN,2011,FEMALE,0,0,396,0,396,546.0
KAITLYN,2011,FEMALE,1584,3024,4464,2448,11520,59.0
KALIYAH,2011,FEMALE,0,504,0,0,504,442.0
KAMILA,2011,FEMALE,0,0,1296,0,1296,258.0
KAMIYAH,2011,FEMALE,0,360,0,0,360,587.0
KAREN,2011,FEMALE,1584,0,2952,0,4536,126.0
KARLA,2011,FEMALE,0,0,900,0,900,298.0
KATE,2011,FEMALE,1080,0,2916,1836,5832,98.0
KATELYN,2011,FEMALE,1008,0,1656,0,2664,181.0
KATELYNN,2011,FEMALE,0,0,360,0,360,587.0
KATHERINE,2011,FEMALE,2268,0,6480,4752,13500,48.0
KATHRYN,2011,FEMALE,0,0,0,432,432,508.0
KATIE,2011,FEMALE,1296,0,864,0,2160,206.0
KAYLA,2011,FEMALE,3024,11232,8928,6480,29664,19.0
KAYLEE,2011,FEMALE,2880,3600,11952,1584,20016,32.0
KAYLEEN,2011,FEMALE,0,0,684,0,684,361.0
KAYLEIGH,2011,FEMALE,0,0,360,0,360,587.0
KAYLIE,2011,FEMALE,0,0,540,0,540,417.0
KAYLIN,2011,FEMALE,0,0,432,0,432,508.0
KEILY,2011,FEMALE,0,0,612,0,612,379.0
KELLY,2011,FEMALE,1584,0,2952,0,4536,126.0
KELSEY,2011,FEMALE,0,396,0,0,396,546.0
KENDRA,2011,FEMALE,0,432,0,0,432,508.0
KENNEDY,2011,FEMALE,0,468,0,0,468,474.0
KENYA,2011,FEMALE,0,360,0,0,360,587.0
KEYLA,2011,FEMALE,0,0,432,0,432,508.0
KHLOE,2011,FEMALE,1105,4284,5814,0,11203,62.0
KIARA,2011,FEMALE,0,936,2592,0,3528,154.0
KIMBERLY,2011,FEMALE,0,0,3708,0,3708,149.0
KIMORA,2011,FEMALE,0,828,0,0,828,315.0
KIRA,2011,FEMALE,0,0,0,396,396,546.0
KRYSTAL,2011,FEMALE,0,0,468,0,468,474.0
KYLA,2011,FEMALE,0,432,0,0,432,508.0
KYLEE,2011,FEMALE,0,0,360,0,360,587.0
KYLIE,2011,FEMALE,1584,2736,5328,1872,11520,59.0
LAILA,2011,FEMALE,0,4212,3132,2484,9828,69.0
LARA,2011,FEMALE,0,0,0,468,468,474.0
LAURA,2011,FEMALE,0,0,1008,1296,2304,195.0
LAUREN,2011,FEMALE,1872,3888,3024,3744,12528,55.0
LAYLA,2011,FEMALE,0,3240,5616,3132,11988,57.0
LEA,2011,FEMALE,0,0,720,2088,2808,175.0
LEAH,2011,FEMALE,2304,5616,17712,26352,51984,8.0
LEELA,2011,FEMALE,360,0,0,0,360,587.0
LEILA,2011,FEMALE,0,0,1440,720,2160,206.0
LEILANI,2011,FEMALE,0,936,2376,0,3312,162.0
LENA,2011,FEMALE,0,0,0,1044,1044,277.0
LEORA,2011,FEMALE,0,0,0,432,432,508.0
LESLEY,2011,FEMALE,0,0,432,0,432,508.0
LESLIE,2011,FEMALE,0,0,2376,0,2376,191.0
LESLY,2011,FEMALE,0,0,576,0,576,394.0
LEYLA,2011,FEMALE,0,0,360,0,360,587.0
LIA,2011,FEMALE,0,0,1872,1656,3528,154.0
LIANA,2011,FEMALE,0,0,1296,1224,2520,188.0
LIBA,2011,FEMALE,0,0,0,720,720,344.0
LIBBY,2011,FEMALE,0,0,0,828,828,315.0
LILA,2011,FEMALE,0,0,0,1224,1224,260.0
LILAH,2011,FEMALE,0,0,0,432,432,508.0
LILIANA,2011,FEMALE,0,0,2016,2088,4104,138.0
LILLIAN,2011,FEMALE,1152,0,0,3384,4536,126.0
LILLY,2011,FEMALE,0,0,0,468,468,474.0
LILY,2011,FEMALE,1620,0,2268,8748,12636,54.0
LINA,2011,FEMALE,0,0,0,468,468,474.0
LINDSAY,2011,FEMALE,0,0,432,0,432,508.0
LIZBETH,2011,FEMALE,0,0,1080,0,1080,273.0
LOLA,2011,FEMALE,0,0,0,792,792,323.0
LONDON,2011,FEMALE,0,9936,2916,1080,13932,46.0
LONDYN,2011,FEMALE,0,900,0,0,900,298.0
LUCIA,2011,FEMALE,0,0,1320,1265,2585,187.0
LUCY,2011,FEMALE,0,0,0,1692,1692,236.0
LUNA,2011,FEMALE,0,0,864,0,864,309.0
LUZ,2011,FEMALE,0,0,900,0,900,298.0
LYLA,2011,FEMALE,0,0,0,756,756,337.0
LYRIC,2011,FEMALE,0,468,0,0,468,474.0
MACKENZIE,2011,FEMALE,0,720,0,1296,2016,213.0
MADELEINE,2011,FEMALE,0,0,0,864,864,309.0
MADELINE,2011,FEMALE,0,0,1080,2808,3888,143.0
MADELYN,2011,FEMALE,0,0,1152,1080,2232,200.0
MADISON,2011,FEMALE,2736,25344,17568,8208,53856,7.0
MAEVE,2011,FEMALE,0,0,0,756,756,337.0
MAGGIE,2011,FEMALE,360,0,0,0,360,587.0
MAKAYLA,2011,FEMALE,0,7236,3456,1296,11988,57.0
MALAK,2011,FEMALE,0,0,0,540,540,417.0
MALIA,2011,FEMALE,0,612,0,0,612,379.0
MALIYAH,2011,FEMALE,0,504,0,0,504,442.0
MALKA,2011,FEMALE,0,0,0,2268,2268,199.0
MALKY,2011,FEMALE,0,0,0,2124,2124,210.0
MANDY,2011,FEMALE,432,0,0,0,432,508.0
MARGARET,2011,FEMALE,0,0,0,900,900,298.0
MARIA,2011,FEMALE,0,0,4248,2808,7056,84.0
MARIAH,2011,FEMALE,0,1512,2376,0,3888,143.0
MARIAM,2011,FEMALE,0,2304,0,1224,3528,154.0
MARIAMA,2011,FEMALE,0,792,0,0,792,323.0
MARIANA,2011,FEMALE,0,0,432,0,432,508.0
MARILYN,2011,FEMALE,0,0,360,0,360,587.0
MARISOL,2011,FEMALE,0,0,360,0,360,587.0
MARY,2011,FEMALE,0,0,0,576,576,394.0
MARYAM,2011,FEMALE,1224,720,0,0,1944,218.0
MATILDA,2011,FEMALE,0,0,0,504,504,442.0
MAYA,2011,FEMALE,3888,3600,7056,13536,28080,21.0
MCKENZIE,2011,FEMALE,0,900,0,0,900,298.0
MEGAN,2011,FEMALE,720,0,792,0,1512,245.0
MELANIE,2011,FEMALE,0,1944,11772,1296,15012,44.0
MELANY,2011,FEMALE,0,0,504,0,504,442.0
MELISSA,2011,FEMALE,0,0,1800,0,1800,230.0
MELODY,2011,FEMALE,936,0,1656,0,2592,182.0
MIA,2011,FEMALE,5184,5184,32976,16704,60048,4.0
MIAH,2011,FEMALE,0,0,612,0,612,379.0
MICHAELA,2011,FEMALE,0,0,0,540,540,417.0
MICHAL,2011,FEMALE,0,0,0,576,576,394.0
MICHELLE,2011,FEMALE,6048,1872,7344,5040,20304,31.0
MIKAELA,2011,FEMALE,0,0,504,0,504,442.0
MIKAYLA,2011,FEMALE,0,2268,2808,1296,6372,94.0
MILA,2011,FEMALE,1836,0,2052,3348,7236,83.0
MILAN,2011,FEMALE,0,1008,0,0,1008,280.0
MILENA,2011,FEMALE,0,0,0,468,468,474.0
MILEY,2011,FEMALE,0,0,612,0,612,379.0
MINA,2011,FEMALE,432,0,0,0,432,508.0
MINDY,2011,FEMALE,0,0,0,864,864,309.0
MIRANDA,2011,FEMALE,0,0,396,0,396,546.0
MIRI,2011,FEMALE,0,0,0,360,360,587.0
MIRIAM,2011,FEMALE,0,0,792,9432,10224,66.0
MOLLY,2011,FEMALE,0,0,0,1296,1296,258.0
MORGAN,2011,FEMALE,0,2232,0,1440,3672,150.0
MYA,2011,FEMALE,0,2304,2088,0,4392,132.0
NADIA,2011,FEMALE,0,1152,1008,0,2160,206.0
NAHLA,2011,FEMALE,0,468,0,0,468,474.0
NANA,2011,FEMALE,0,360,0,0,360,587.0
NANCY,2011,FEMALE,0,0,360,0,360,587.0
NAOMI,2011,FEMALE,0,3672,2376,4968,11016,63.0
NATALIA,2011,FEMALE,0,1296,5400,2160,8856,74.0
NATALIE,2011,FEMALE,2760,1265,6348,5520,15893,43.0
NATALY,2011,FEMALE,0,0,468,0,468,474.0
NATASHA,2011,FEMALE,0,0,396,0,396,546.0
NATHALIA,2011,FEMALE,0,0,360,0,360,587.0
NATHALIE,2011,FEMALE,0,0,936,0,936,287.0
NATHALY,2011,FEMALE,0,0,720,0,720,344.0
NAYELI,2011,FEMALE,0,0,612,0,612,379.0
NECHAMA,2011,FEMALE,0,0,0,900,900,298.0
NEVAEH,2011,FEMALE,0,4320,2304,0,6624,90.0
NIA,2011,FEMALE,0,1368,0,0,1368,253.0
NICOLE,2011,FEMALE,3564,0,7668,4860,16092,42.0
NICOLETTE,2011,FEMALE,0,0,0,360,360,587.0
NINA,2011,FEMALE,2268,0,1188,4212,7668,81.0
NOA,2011,FEMALE,0,0,0,1224,1224,260.0
NOEMI,2011,FEMALE,0,0,396,0,396,546.0
NORA,2011,FEMALE,0,0,0,828,828,315.0
NYLA,2011,FEMALE,0,3096,1152,0,4248,136.0
NYLAH,2011,FEMALE,0,1512,0,0,1512,245.0
OLIVIA,2011,FEMALE,12816,7488,12384,30672,63360,3.0
PAIGE,2011,FEMALE,0,2376,0,936,3312,162.0
PAOLA,2011,FEMALE,0,0,360,0,360,587.0
PARIS,2011,FEMALE,0,1152,0,0,1152,268.0
PARKER,2011,FEMALE,0,0,0,468,468,474.0
PEARL,2011,FEMALE,0,0,0,828,828,315.0
PENELOPE,2011,FEMALE,0,0,1008,2736,3744,147.0
PEREL,2011,FEMALE,0,0,0,540,540,417.0
PERLA,2011,FEMALE,0,0,432,0,432,508.0
PESSY,2011,FEMALE,0,0,0,936,936,287.0
PEYTON,2011,FEMALE,0,720,0,0,720,344.0
PHOEBE,2011,FEMALE,1296,0,0,1656,2952,170.0
PIPER,2011,FEMALE,0,0,0,396,396,546.0
PRINCESS,2011,FEMALE,0,576,0,0,576,394.0
QUEENIE,2011,FEMALE,540,0,0,0,540,417.0
QUINN,2011,FEMALE,0,0,0,360,360,587.0
RACHEL,2011,FEMALE,2592,1440,3600,24624,32256,16.0
RAINA,2011,FEMALE,396,0,0,0,396,546.0
RAIZEL,2011,FEMALE,0,0,0,720,720,344.0
RAIZY,2011,FEMALE,0,0,0,1836,1836,227.0
RAQUEL,2011,FEMALE,0,0,396,0,396,546.0
REBECCA,2011,FEMALE,1872,1728,1440,7776,12816,53.0
REESE,2011,FEMALE,0,0,0,468,468,474.0
RENEE,2011,FEMALE,360,0,0,0,360,587.0
RIFKA,2011,FEMALE,0,0,0,432,432,508.0
RIFKY,2011,FEMALE,0,0,0,468,468,474.0
RIHANNA,2011,FEMALE,0,0,756,0,756,337.0
RILEY,2011,FEMALE,0,1620,1296,3024,5940,97.0
RIVKA,2011,FEMALE,0,0,0,4068,4068,140.0
RIVKY,2011,FEMALE,0,0,0,1548,1548,244.0
ROCHEL,2011,FEMALE,0,0,0,792,792,323.0
ROIZY,2011,FEMALE,0,0,0,468,468,474.0
ROSA,2011,FEMALE,0,0,360,0,360,587.0
ROSE,2011,FEMALE,0,0,792,2520,3312,162.0
ROSELYN,2011,FEMALE,0,0,576,0,576,394.0
RUBY,2011,FEMALE,0,0,1440,2016,3456,159.0
RUCHY,2011,FEMALE,0,0,0,432,432,508.0
RUTH,2011,FEMALE,0,0,0,396,396,546.0
RYAN,2011,FEMALE,0,0,0,504,504,442.0
SABRINA,2011,FEMALE,2484,0,2700,3672,8856,74.0
SADE,2011,FEMALE,0,576,0,0,576,394.0
SADIE,2011,FEMALE,0,0,792,2304,3096,169.0
SALMA,2011,FEMALE,0,0,0,612,612,379.0
SAMANTHA,2011,FEMALE,3168,3888,14400,10656,32112,17.0
SAMARA,2011,FEMALE,0,792,864,0,1656,237.0
SAMIYA,2011,FEMALE,0,360,0,0,360,587.0
SAMIYAH,2011,FEMALE,0,648,0,0,648,371.0
SANAA,2011,FEMALE,0,936,0,0,936,287.0
SANAI,2011,FEMALE,0,756,0,0,756,337.0
SANIYA,2011,FEMALE,0,468,0,0,468,474.0
SANIYAH,2011,FEMALE,0,468,0,0,468,474.0
SARA,2011,FEMALE,2592,0,3132,11556,17280,37.0
SARAH,2011,FEMALE,5472,5760,7632,25488,44352,10.0
SARAI,2011,FEMALE,0,1080,1728,0,2808,175.0
SARIAH,2011,FEMALE,0,1224,720,0,1944,218.0
SASHA,2011,FEMALE,0,1512,1080,1728,4320,134.0
SAVANNA,2011,FEMALE,0,0,360,0,360,587.0
SAVANNAH,2011,FEMALE,0,4536,4104,1728,10368,65.0
SCARLET,2011,FEMALE,0,0,1044,0,1044,277.0
SCARLETT,2011,FEMALE,0,0,4680,2232,6912,86.0
SELENA,2011,FEMALE,936,0,1080,0,2016,213.0
SELINA,2011,FEMALE,936,0,0,0,936,287.0
SERENA,2011,FEMALE,1224,0,0,1152,2376,191.0
SERENITY,2011,FEMALE,0,3744,2664,0,6408,92.0
SHAINA,2011,FEMALE,0,0,0,576,576,394.0
SHAINDEL,2011,FEMALE,0,0,0,540,540,417.0
SHAINDY,2011,FEMALE,0,0,0,1728,1728,234.0
SHANIA,2011,FEMALE,0,504,0,0,504,442.0
SHANIYA,2011,FEMALE,0,396,0,0,396,546.0
SHARON,2011,FEMALE,720,0,0,0,720,344.0
SHERLYN,2011,FEMALE,0,0,468,0,468,474.0
SHEVY,2011,FEMALE,0,0,0,360,360,587.0
SHIFRA,2011,FEMALE,0,0,0,720,720,344.0
SHILOH,2011,FEMALE,0,540,0,0,540,417.0
SHIRA,2011,FEMALE,0,0,0,792,792,323.0
SHIRLEY,2011,FEMALE,864,0,1080,0,1944,218.0
SHOSHANA,2011,FEMALE,0,0,0,792,792,323.0
SIENA,2011,FEMALE,0,0,0,576,576,394.0
SIENNA,2011,FEMALE,0,0,1224,2736,3960,142.0
SIMA,2011,FEMALE,0,0,0,684,684,361.0
SIMI,2011,FEMALE,0,0,0,360,360,587.0
SIMONE,2011,FEMALE,0,0,0,540,540,417.0
SKYE,2011,FEMALE,0,540,0,0,540,417.0
SKYLA,2011,FEMALE,0,1368,1512,0,2880,172.0
SKYLAR,2011,FEMALE,0,2160,1296,1836,5292,109.0
SLOANE,2011,FEMALE,0,0,0,612,612,379.0
SOFIA,2011,FEMALE,2052,0,17820,13176,33048,15.0
SOPHIA,2011,FEMALE,17136,4320,32112,25920,79488,2.0
SOPHIE,2011,FEMALE,2700,0,1296,7020,11016,63.0
SORAYA,2011,FEMALE,0,360,0,0,360,587.0
STACY,2011,FEMALE,0,0,360,0,360,587.0
STELLA,2011,FEMALE,1188,0,1188,7452,9828,69.0
STEPHANIE,2011,FEMALE,1584,0,3600,0,5184,111.0
STEPHANY,2011,FEMALE,0,0,396,0,396,546.0
SUMMER,2011,FEMALE,0,1080,0,1152,2232,200.0
SURI,2011,FEMALE,0,0,0,504,504,442.0
SURY,2011,FEMALE,0,0,0,720,720,344.0
SYDNEY,2011,FEMALE,0,1728,0,2520,4248,136.0
SYEDA,2011,FEMALE,576,0,0,0,576,394.0
SYLVIA,2011,FEMALE,0,0,0,396,396,546.0
SYMPHONY,2011,FEMALE,0,468,0,0,468,474.0
TABITHA,2011,FEMALE,0,360,0,0,360,587.0
TALIA,2011,FEMALE,0,0,0,936,936,287.0
TAMAR,2011,FEMALE,0,0,0,396,396,546.0
TAMIA,2011,FEMALE,0,612,0,0,612,379.0
TANISHA,2011,FEMALE,360,0,0,0,360,587.0
TARAJI,2011,FEMALE,0,432,0,0,432,508.0
TATIANA,2011,FEMALE,0,0,396,0,396,546.0
TAYLOR,2011,FEMALE,0,5724,1404,2700,9828,69.0
TENZIN,2011,FEMALE,936,0,0,0,936,287.0
TESSA,2011,FEMALE,0,0,0,504,504,442.0
TIANA,2011,FEMALE,0,1368,792,0,2160,206.0
TIANNA,2011,FEMALE,0,468,0,0,468,474.0
TIFFANY,2011,FEMALE,3888,0,1728,0,5616,102.0
TINA,2011,FEMALE,504,0,0,0,504,442.0
TOBY,2011,FEMALE,0,0,0,1404,1404,250.0
TORI,2011,FEMALE,0,576,0,0,576,394.0
TRINITY,2011,FEMALE,0,1008,0,0,1008,280.0
TZIPORA,2011,FEMALE,0,0,0,432,432,508.0
TZIPORAH,2011,FEMALE,0,0,0,360,360,587.0
TZIPPY,2011,FEMALE,0,0,0,360,360,587.0
TZIVIA,2011,FEMALE,0,0,0,504,504,442.0
VALENTINA,2011,FEMALE,0,0,6120,2232,8352,76.0
VALERIA,2011,FEMALE,0,0,1620,0,1620,242.0
VALERIE,2011,FEMALE,0,0,3816,792,4608,122.0
VANESSA,2011,FEMALE,1620,0,4536,1512,7668,81.0
VERA,2011,FEMALE,0,0,0,684,684,361.0
VERONICA,2011,FEMALE,0,0,720,1584,2304,195.0
VERONIKA,2011,FEMALE,0,0,0,396,396,546.0
VICKY,2011,FEMALE,1152,0,0,0,1152,268.0
VICTORIA,2011,FEMALE,2530,4968,15732,11592,34822,14.0
VIOLET,2011,FEMALE,0,0,1008,2736,3744,147.0
VIVIAN,2011,FEMALE,3168,0,0,2160,5328,108.0
VIVIANA,2011,FEMALE,0,0,396,0,396,546.0
VIVIENNE,2011,FEMALE,0,0,0,756,756,337.0
WENDY,2011,FEMALE,1152,0,864,0,2016,213.0
WILLA,2011,FEMALE,0,0,0,468,468,474.0
WINNIE,2011,FEMALE,900,0,0,0,900,298.0
XIMENA,2011,FEMALE,0,0,648,0,648,371.0
XIN,2011,FEMALE,648,0,0,0,648,371.0
YACHET,2011,FEMALE,0,0,0,468,468,474.0
YAEL,2011,FEMALE,0,0,0,756,756,337.0
YAMILET,2011,FEMALE,0,0,396,0,396,546.0
YARETZI,2011,FEMALE,0,0,792,0,792,323.0
YASMINE,2011,FEMALE,0,0,0,360,360,587.0
YEHUDIS,2011,FEMALE,0,0,0,828,828,315.0
YIDES,2011,FEMALE,0,0,0,900,900,298.0
YITTY,2011,FEMALE,0,0,0,1152,1152,268.0
YOCHEVED,2011,FEMALE,0,0,0,720,720,344.0
YU,2011,FEMALE,468,0,0,0,468,474.0
ZAHARA,2011,FEMALE,0,360,0,0,360,587.0
ZAHRA,2011,FEMALE,684,0,0,0,684,361.0
ZAINAB,2011,FEMALE,828,0,0,0,828,315.0
ZANIYAH,2011,FEMALE,0,360,0,0,360,587.0
ZARA,2011,FEMALE,1008,792,0,0,1800,230.0
ZARIA,2011,FEMALE,0,468,0,0,468,474.0
ZARIAH,2011,FEMALE,0,504,0,0,504,442.0
ZISSY,2011,FEMALE,0,0,0,900,900,298.0
ZOE,2011,FEMALE,3450,5934,8970,9315,27669,22.0
ZOEY,2011,FEMALE,0,3132,2916,2268,8316,77.0
ZURI,2011,FEMALE,0,360,0,0,360,587.0
AARAV,2011,MALE,540,0,0,0,540,395.0
AARON,2011,MALE,7344,7632,14688,9648,39312,35.0
ABDIEL,2011,MALE,0,0,432,0,432,467.0
ABDOUL,2011,MALE,0,576,0,0,576,377.0
ABDOULAYE,2011,MALE,0,468,0,0,468,439.0
ABDUL,2011,MALE,720,0,0,0,720,328.0
ABDULLAH,2011,MALE,1080,0,0,0,1080,268.0
ABEL,2011,MALE,0,0,504,0,504,415.0
ABRAHAM,2011,MALE,0,0,1584,12384,13968,80.0
ADAM,2011,MALE,4032,4032,4608,18576,31248,41.0
ADEN,2011,MALE,0,1368,936,0,2304,188.0
ADITYA,2011,MALE,504,0,0,0,504,415.0
ADONIS,2011,MALE,0,792,1152,0,1944,209.0
ADRIAN,2011,MALE,2736,2592,22608,5040,32976,38.0
ADRIEL,2011,MALE,0,0,1224,0,1224,252.0
AHARON,2011,MALE,0,0,0,684,684,340.0
AHMED,2011,MALE,2268,1188,0,2808,6264,114.0
AHRON,2011,MALE,0,0,0,612,612,366.0
AIDAN,2011,MALE,4608,2880,5184,8352,21024,53.0
AIDEN,2011,MALE,13824,24048,27072,11232,76176,8.0
AKIVA,2011,MALE,0,0,0,720,720,328.0
ALAN,2011,MALE,3996,0,4104,2268,10368,96.0
ALBERT,2011,MALE,0,0,936,1080,2016,204.0
ALBERTO,2011,MALE,0,0,540,0,540,395.0
ALDO,2011,MALE,0,0,360,0,360,533.0
ALEC,2011,MALE,0,0,0,396,396,493.0
ALEJANDRO,2011,MALE,0,0,2448,0,2448,183.0
ALEX,2011,MALE,5616,0,7344,3672,16632,69.0
ALEXANDER,2011,MALE,6768,5616,31536,28368,72288,9.0
ALEXIS,2011,MALE,0,0,1980,0,1980,207.0
ALFREDO,2011,MALE,0,0,540,0,540,395.0
ALI,2011,MALE,1404,1188,0,3564,6156,116.0
ALIJAH,2011,MALE,0,360,0,0,360,533.0
ALLAN,2011,MALE,0,0,360,0,360,533.0
ALLEN,2011,MALE,1512,0,2376,1188,5076,127.0
ALVIN,2011,MALE,4644,1080,1080,0,6804,111.0
AMADOU,2011,MALE,0,540,0,0,540,395.0
AMAR'E,2011,MALE,0,432,0,0,432,467.0
AMARE,2011,MALE,0,540,0,0,540,395.0
AMARI,2011,MALE,0,2052,0,0,2052,203.0
AMIR,2011,MALE,0,9612,2268,1620,13500,83.0
AMROM,2011,MALE,0,0,0,468,468,439.0
ANDERSON,2011,MALE,0,0,1188,0,1188,254.0
ANDRE,2011,MALE,0,1584,720,0,2304,188.0
ANDRES,2011,MALE,0,0,1836,0,1836,218.0
ANDREW,2011,MALE,10080,5184,18000,19152,52416,19.0
ANDY,2011,MALE,3096,0,2664,0,5760,122.0
ANGEL,2011,MALE,0,720,18216,0,18936,62.0
ANGELO,2011,MALE,0,0,2016,1152,3168,160.0
ANSON,2011,MALE,648,0,0,0,648,354.0
ANTHONY,2011,MALE,6624,9504,29808,19440,65376,12.0
ANTONIO,2011,MALE,0,1620,3456,3024,8100,105.0
ARI,2011,MALE,0,0,0,1080,1080,268.0
ARIEL,2011,MALE,0,0,1716,1650,3366,156.0
ARJUN,2011,MALE,972,0,0,0,972,283.0
ARMAAN,2011,MALE,540,0,0,0,540,395.0
ARMANDO,2011,MALE,0,0,396,0,396,493.0
ARMANI,2011,MALE,0,0,720,0,720,328.0
ARON,2011,MALE,0,0,0,2160,2160,197.0
ARTHUR,2011,MALE,0,0,0,1044,1044,273.0
ARTURO,2011,MALE,0,0,360,0,360,533.0
ARYAN,2011,MALE,648,0,0,0,648,354.0
ARYEH,2011,MALE,0,0,0,864,864,299.0
ASHER,2011,MALE,0,0,0,1980,1980,207.0
ASHTON,2011,MALE,0,1944,1836,1080,4860,129.0
AUGUST,2011,MALE,0,0,0,576,576,377.0
AUGUSTUS,2011,MALE,0,0,0,360,360,533.0
AUSTIN,2011,MALE,9216,1872,2160,3744,16992,65.0
AVERY,2011,MALE,0,1368,936,0,2304,188.0
AVI,2011,MALE,0,0,0,432,432,467.0
AVRAHAM,2011,MALE,0,0,0,1368,1368,239.0
AVROHOM,2011,MALE,0,0,0,972,972,283.0
AVRUM,2011,MALE,0,0,0,396,396,493.0
AXEL,2011,MALE,0,0,2484,0,2484,182.0
AYAAN,2011,MALE,1116,0,0,0,1116,263.0
AYDEN,2011,MALE,3456,12672,14976,1440,32544,39.0
BARUCH,2011,MALE,0,0,0,756,756,318.0
BECKETT,2011,MALE,0,0,0,432,432,467.0
BEN,2011,MALE,0,0,0,792,792,315.0
BENJAMIN,2011,MALE,5616,1872,7344,33120,47952,23.0
BENNETT,2011,MALE,0,0,0,360,360,533.0
BENSON,2011,MALE,684,0,0,0,684,340.0
BENZION,2011,MALE,0,0,0,468,468,439.0
BERISH,2011,MALE,0,0,0,360,360,533.0
BINYOMIN,2011,MALE,0,0,0,504,504,415.0
BLAKE,2011,MALE,0,1368,0,1008,2376,185.0
BORUCH,2011,MALE,0,0,0,576,576,377.0
BRADLEY,2011,MALE,0,0,864,0,864,299.0
BRADY,2011,MALE,0,0,0,468,468,439.0
BRANDON,2011,MALE,4176,8208,26496,6336,45216,29.0
BRAYAN,2011,MALE,0,0,828,0,828,308.0
BRAYDEN,2011,MALE,0,0,1152,1080,2232,194.0
BRENDAN,2011,MALE,0,0,0,828,828,308.0
BRIAN,2011,MALE,5520,3036,6785,4140,19481,60.0
BRODY,2011,MALE,0,0,0,684,684,340.0
BRYAN,2011,MALE,2160,1440,14256,2016,19872,57.0
BRYANT,2011,MALE,0,0,612,0,612,366.0
BRYCE,2011,MALE,0,3780,1080,1080,5940,120.0
BRYSON,2011,MALE,0,504,0,0,504,415.0
BYRON,2011,MALE,0,0,684,0,684,340.0
CADEN,2011,MALE,0,0,0,360,360,533.0
CALEB,2011,MALE,2304,6336,6048,4464,19152,61.0
CALVIN,2011,MALE,936,0,0,720,1656,226.0
CAMERON,2011,MALE,0,4794,1938,2295,9027,101.0
CARLOS,2011,MALE,0,0,3924,0,3924,143.0
CARMELO,2011,MALE,0,936,1152,0,2088,200.0
CARMINE,2011,MALE,0,0,0,396,396,493.0
CARSON,2011,MALE,720,0,0,0,720,328.0
CARTER,2011,MALE,0,2520,0,1368,3888,144.0
CAYDEN,2011,MALE,0,396,0,0,396,493.0
CESAR,2011,MALE,0,0,1044,0,1044,273.0
CHAD,2011,MALE,0,432,0,0,432,467.0
CHAIM,2011,MALE,0,0,0,5292,5292,125.0
CHANCE,2011,MALE,0,540,0,0,540,395.0
CHARLES,2011,MALE,2448,2160,2880,18576,26064,48.0
CHARLIE,2011,MALE,0,0,0,720,720,328.0
CHASE,2011,MALE,0,4182,2244,2125,8551,103.0
CHESKEL,2011,MALE,0,0,0,504,504,415.0
CHRIS,2011,MALE,0,720,1944,0,2664,169.0
CHRISTIAN,2011,MALE,3024,13104,21744,10944,48816,22.0
CHRISTOPHER,2011,MALE,3024,11520,34416,13248,62208,15.0
CODY,2011,MALE,720,720,0,0,1440,236.0
COLE,2011,MALE,0,0,0,1332,1332,245.0
COLIN,2011,MALE,0,0,0,1152,1152,259.0
CONNOR,2011,MALE,792,0,0,3816,4608,133.0
CONOR,2011,MALE,0,0,0,468,468,439.0
COOPER,2011,MALE,0,0,0,1080,1080,268.0
COREY,2011,MALE,0,360,0,0,360,533.0
CRISTIAN,2011,MALE,0,0,1908,0,1908,213.0
CRISTOFER,2011,MALE,0,0,396,0,396,493.0
CRISTOPHER,2011,MALE,0,0,468,0,468,439.0
DAMIAN,2011,MALE,0,0,936,0,936,289.0
DAMIEN,2011,MALE,0,0,540,0,540,395.0
DANIEL,2011,MALE,12096,11664,31824,30240,85824,6.0
DANNY,2011,MALE,1440,0,2232,0,3672,147.0
DANTE,2011,MALE,0,0,756,0,756,318.0
DARIEL,2011,MALE,0,0,1116,0,1116,263.0
DARIUS,2011,MALE,0,432,0,0,432,467.0
DARREN,2011,MALE,1512,864,0,0,2376,185.0
DARWIN,2011,MALE,0,0,648,0,648,354.0
DASHIELL,2011,MALE,0,0,0,432,432,467.0
DAVID,2011,MALE,3864,11592,20470,35604,71530,10.0
DEAN,2011,MALE,0,0,0,864,864,299.0
DECLAN,2011,MALE,0,0,0,1152,1152,259.0
DENNIS,2011,MALE,0,0,1080,792,1872,216.0
DERECK,2011,MALE,0,0,396,0,396,493.0
DEREK,2011,MALE,3456,0,6696,1080,11232,92.0
DERICK,2011,MALE,0,0,648,0,648,354.0
DERRICK,2011,MALE,0,360,0,0,360,533.0
DEVIN,2011,MALE,3024,3456,3600,2592,12672,87.0
DEVON,2011,MALE,0,360,0,0,360,533.0
DIEGO,2011,MALE,0,0,1944,0,1944,209.0
DOMINIC,2011,MALE,0,1836,2376,1620,5832,121.0
DOMINICK,2011,MALE,0,0,1152,1512,2664,169.0
DONOVAN,2011,MALE,0,360,0,0,360,533.0
DOV,2011,MALE,0,0,0,1656,1656,226.0
DOVID,2011,MALE,0,0,0,1440,1440,236.0
DWAYNE,2011,MALE,0,504,0,0,504,415.0
DYLAN,2011,MALE,7314,5796,18768,14605,46483,25.0
EASON,2011,MALE,360,0,0,0,360,533.0
EDDIE,2011,MALE,0,0,432,0,432,467.0
EDGAR,2011,MALE,0,0,1044,0,1044,273.0
EDISON,2011,MALE,1008,0,792,0,1800,220.0
EDUARDO,2011,MALE,0,0,1620,0,1620,229.0
EDWARD,2011,MALE,0,1080,3240,4428,8748,102.0
EDWIN,2011,MALE,1080,0,5112,0,6192,115.0
EFRAIM,2011,MALE,0,0,0,900,900,294.0
EITAN,2011,MALE,0,0,0,504,504,415.0
ELI,2011,MALE,0,2376,4104,10476,16956,67.0
ELIAN,2011,MALE,0,0,612,0,612,366.0
ELIAS,2011,MALE,0,1512,7128,2268,10908,94.0
ELIEZER,2011,MALE,0,0,0,1368,1368,239.0
ELIJAH,2011,MALE,1728,22464,15840,5040,45072,30.0
ELIMELECH,2011,MALE,0,0,0,576,576,377.0
ELIYAHU,2011,MALE,0,0,0,1296,1296,246.0
ELLIOT,2011,MALE,0,0,0,1188,1188,254.0
ELLIOTT,2011,MALE,0,0,0,432,432,467.0
ELLIS,2011,MALE,0,0,0,360,360,533.0
ELVIS,2011,MALE,792,0,720,0,1512,233.0
EMANUEL,2011,MALE,0,0,936,0,936,289.0
EMILIANO,2011,MALE,0,0,468,0,468,439.0
EMILIO,2011,MALE,0,0,756,0,756,318.0
EMMANUEL,2011,MALE,0,3312,4104,0,7416,109.0
ENRIQUE,2011,MALE,0,0,504,0,504,415.0
ERIC,2011,MALE,12240,2016,8640,3888,26784,46.0
ERICK,2011,MALE,0,0,2160,0,2160,197.0
ERIK,2011,MALE,0,0,648,0,648,354.0
ESTEBAN,2011,MALE,0,0,468,0,468,439.0
ETHAN,2011,MALE,24426,17112,28865,16284,86687,3.0
EVAN,2011,MALE,7344,3744,11664,8640,31392,40.0
EZEKIEL,2011,MALE,0,0,396,0,396,493.0
EZEQUIEL,2011,MALE,0,0,396,0,396,493.0
EZRA,2011,MALE,0,0,0,1188,1188,254.0
FARHAN,2011,MALE,612,0,0,0,612,366.0
FELIX,2011,MALE,2376,0,1296,2484,6156,116.0
FERNANDO,2011,MALE,0,0,1008,0,1008,280.0
FILIP,2011,MALE,0,0,0,468,468,439.0
FINN,2011,MALE,0,0,0,828,828,308.0
FRANCESCO,2011,MALE,0,0,0,684,684,340.0
FRANCISCO,2011,MALE,0,0,1152,0,1152,259.0
FRANK,2011,MALE,0,0,1224,2088,3312,157.0
FRANKLIN,2011,MALE,0,0,504,0,504,415.0
FREDDY,2011,MALE,0,0,468,0,468,439.0
GABRIEL,2011,MALE,1872,5184,22752,13824,43632,33.0
GAEL,2011,MALE,0,0,648,0,648,354.0
GAVIN,2011,MALE,3888,2592,2736,7632,16848,68.0
GAVRIEL,2011,MALE,0,0,0,540,540,395.0
GEORGE,2011,MALE,1728,1440,4320,9504,16992,65.0
GERARDO,2011,MALE,0,0,432,0,432,467.0
GIOVANI,2011,MALE,0,0,360,0,360,533.0
GIOVANNI,2011,MALE,0,1512,7344,3780,12636,88.0
GIOVANNY,2011,MALE,0,0,468,0,468,439.0
GRAHAM,2011,MALE,0,0,0,756,756,318.0
GRANT,2011,MALE,0,0,0,504,504,415.0
GRAYSON,2011,MALE,0,0,0,684,684,340.0
GREGORY,2011,MALE,0,0,1152,1152,2304,188.0
GREYSON,2011,MALE,0,0,0,396,396,493.0
GRIFFIN,2011,MALE,0,0,0,756,756,318.0
GUSTAVO,2011,MALE,0,0,540,0,540,395.0
HARRISON,2011,MALE,936,0,0,2880,3816,145.0
HARRY,2011,MALE,0,0,0,576,576,377.0
HASSAN,2011,MALE,0,360,0,0,360,533.0
HAYDEN,2011,MALE,720,864,0,0,1584,231.0
HECTOR,2011,MALE,0,0,1116,0,1116,263.0
HENRY,2011,MALE,2268,0,4644,16092,23004,52.0
HERSH,2011,MALE,0,0,0,504,504,415.0
HERSHEL,2011,MALE,0,0,0,864,864,299.0
HERSHY,2011,MALE,0,0,0,756,756,318.0
HUDSON,2011,MALE,0,0,0,1908,1908,213.0
HUGO,2011,MALE,0,0,0,396,396,493.0
HUNTER,2011,MALE,0,1296,1620,3132,6048,118.0
IAN,2011,MALE,3168,3024,10368,4032,20592,55.0
IBRAHIM,2011,MALE,1122,1375,0,0,2497,181.0
IBRAHIMA,2011,MALE,0,396,0,0,396,493.0
IKER,2011,MALE,0,0,468,0,468,439.0
ILAN,2011,MALE,0,0,0,612,612,366.0
ISAAC,2011,MALE,1872,2592,10512,13248,28224,43.0
ISAIAH,2011,MALE,0,11340,7560,1728,20628,54.0
ISHAAN,2011,MALE,360,0,0,0,360,533.0
ISHMAEL,2011,MALE,0,360,0,0,360,533.0
ISIAH,2011,MALE,0,396,0,0,396,493.0
ISMAEL,2011,MALE,0,0,612,0,612,366.0
ISRAEL,2011,MALE,0,0,1584,2016,3600,152.0
IVAN,2011,MALE,7128,0,4536,1404,13068,85.0
JACE,2011,MALE,0,1512,2664,0,4176,139.0
JACK,2011,MALE,2268,0,2268,19764,24300,50.0
JACKSON,2011,MALE,1404,1188,0,8316,10908,94.0
JACKY,2011,MALE,720,0,0,0,720,328.0
JACOB,2011,MALE,6762,11316,41814,30475,90367,2.0
JADEN,2011,MALE,2484,8100,7884,0,18468,63.0
JADIEL,2011,MALE,0,0,1836,0,1836,218.0
JAHEIM,2011,MALE,0,360,0,0,360,533.0
JAHMIR,2011,MALE,0,504,0,0,504,415.0
JAIDEN,2011,MALE,0,2520,3024,0,5544,123.0
JAIME,2011,MALE,0,0,396,0,396,493.0
JAKE,2011,MALE,1836,0,2916,8316,13068,85.0
JALEN,2011,MALE,0,540,0,0,540,395.0
JAMAL,2011,MALE,0,468,0,0,468,439.0
JAMEL,2011,MALE,0,468,0,0,468,439.0
JAMES,2011,MALE,5184,4752,10080,24768,44784,32.0
JAMIR,2011,MALE,0,432,0,0,432,467.0
JANIEL,2011,MALE,0,0,360,0,360,533.0
JANUEL,2011,MALE,0,0,396,0,396,493.0
JARED,2011,MALE,0,864,1224,0,2088,200.0
JARIEL,2011,MALE,0,0,900,0,900,294.0
JASIAH,2011,MALE,0,576,0,0,576,377.0
JASON,2011,MALE,14112,6336,13248,5040,38736,36.0
JASPER,2011,MALE,0,0,0,720,720,328.0
JAVIER,2011,MALE,0,0,1368,0,1368,239.0
JAY,2011,MALE,1008,0,1296,0,2304,188.0
JAYCE,2011,MALE,0,0,432,0,432,467.0
JAYDEN,2011,MALE,23874,25392,48990,5382,103638,1.0
JAYLEN,2011,MALE,0,1368,0,0,1368,239.0
JAYSON,2011,MALE,0,1008,1728,0,2736,164.0
JEAN,2011,MALE,0,0,1368,0,1368,239.0
JEANCARLOS,2011,MALE,0,0,360,0,360,533.0
JEFFERSON,2011,MALE,0,0,504,0,504,415.0
JEFFREY,2011,MALE,1800,0,1368,0,3168,160.0
JELANI,2011,MALE,0,396,0,0,396,493.0
JENCARLOS,2011,MALE,0,0,396,0,396,493.0
JEREMIAH,2011,MALE,0,11016,8640,0,19656,58.0
JEREMIAS,2011,MALE,0,0,504,0,504,415.0
JEREMY,2011,MALE,1836,1620,12744,0,16200,72.0
JERMAINE,2011,MALE,0,576,0,0,576,377.0
JERRY,2011,MALE,1800,0,792,0,2592,173.0
JESSE,2011,MALE,0,1296,1080,1296,3672,147.0
JESUS,2011,MALE,0,0,2520,0,2520,178.0
JIA,2011,MALE,540,0,0,0,540,395.0
JIMMY,2011,MALE,0,0,504,0,504,415.0
JOAQUIN,2011,MALE,0,0,828,0,828,308.0
JOEL,2011,MALE,0,3996,8856,3240,16092,73.0
JOHAN,2011,MALE,0,0,1008,0,1008,280.0
JOHANN,2011,MALE,0,0,432,0,432,467.0
JOHN,2011,MALE,3024,4896,13824,23904,45648,27.0
JOHNATHAN,2011,MALE,0,0,576,0,576,377.0
JOHNNY,2011,MALE,1296,0,1296,0,2592,173.0
JONAH,2011,MALE,0,0,1080,3744,4824,130.0
JONATHAN,2011,MALE,7200,7632,26352,10224,51408,21.0
JORDAN,2011,MALE,3174,7314,8280,4416,23184,51.0
JORGE,2011,MALE,0,0,1404,0,1404,238.0
JOSE,2011,MALE,0,0,5184,0,5184,126.0
JOSEPH,2011,MALE,3024,5040,20160,40464,68688,11.0
JOSHUA,2011,MALE,5184,18432,27360,12816,63792,13.0
JOSIAH,2011,MALE,0,8712,3600,0,12312,90.0
JOSUE,2011,MALE,0,0,1260,0,1260,250.0
JUAN,2011,MALE,0,0,3564,0,3564,153.0
JUDAH,2011,MALE,0,0,0,1224,1224,252.0
JUDE,2011,MALE,0,0,0,468,468,439.0
JULIAN,2011,MALE,1518,2185,13662,10902,28267,42.0
JULIEN,2011,MALE,0,0,504,0,504,415.0
JULIO,2011,MALE,0,0,972,0,972,283.0
JULIUS,2011,MALE,0,0,936,0,936,289.0
JUNIOR,2011,MALE,0,0,648,0,648,354.0
JUSTICE,2011,MALE,0,396,0,0,396,493.0
JUSTIN,2011,MALE,15840,12240,44640,6624,79344,7.0
KACPER,2011,MALE,0,0,0,396,396,493.0
KADEN,2011,MALE,0,1584,936,0,2520,178.0
KAI,2011,MALE,1296,1512,0,1620,4428,135.0
KAIDEN,2011,MALE,0,1008,0,0,1008,280.0
KALEB,2011,MALE,0,648,0,0,648,354.0
KAMARI,2011,MALE,0,612,0,0,612,366.0
KAMERON,2011,MALE,0,504,0,0,504,415.0
KAYDEN,2011,MALE,0,2664,1800,0,4464,134.0
KEITH,2011,MALE,0,432,0,0,432,467.0
KELVIN,2011,MALE,0,0,792,0,792,315.0
KENNETH,2011,MALE,0,1728,3564,1080,6372,113.0
KENNY,2011,MALE,0,0,720,0,720,328.0
KEVIN,2011,MALE,13248,4032,26352,4176,47808,24.0
KHALIL,2011,MALE,0,684,0,0,684,340.0
KIERAN,2011,MALE,0,0,0,468,468,439.0
KING,2011,MALE,0,504,0,0,504,415.0
KINGSLEY,2011,MALE,1296,0,0,0,1296,246.0
KIYAN,2011,MALE,0,432,0,0,432,467.0
KYLE,2011,MALE,4860,4320,0,2592,11772,91.0
KYMANI,2011,MALE,0,684,0,0,684,340.0
LAMAR,2011,MALE,0,540,0,0,540,395.0
LANDON,2011,MALE,0,1188,2052,1404,4644,132.0
LARRY,2011,MALE,0,0,360,0,360,533.0
LAWRENCE,2011,MALE,504,0,0,0,504,415.0
LAZER,2011,MALE,0,0,0,720,720,328.0
LEANDRO,2011,MALE,0,0,576,0,576,377.0
LEO,2011,MALE,4320,0,1188,9180,14688,78.0
LEON,2011,MALE,1224,0,0,1440,2664,169.0
LEONARDO,2011,MALE,0,0,3960,2088,6048,118.0
LEONEL,2011,MALE,0,0,432,0,432,467.0
LEV,2011,MALE,0,0,0,360,360,533.0
LEVI,2011,MALE,0,1080,0,2880,3960,142.0
LIAM,2011,MALE,3600,8784,14832,18864,46080,26.0
LIPA,2011,MALE,0,0,0,684,684,340.0
LOGAN,2011,MALE,2622,3450,6210,7705,19987,56.0
LORENZO,2011,MALE,0,0,1008,1584,2592,173.0
LOUIS,2011,MALE,1080,0,1512,2484,5076,127.0
LUCA,2011,MALE,0,0,0,2556,2556,177.0
LUCAS,2011,MALE,14832,1728,17568,18432,52560,17.0
LUIS,2011,MALE,0,0,4716,0,4716,131.0
LUKA,2011,MALE,0,0,0,756,756,318.0
LUKAS,2011,MALE,0,0,792,1152,1944,209.0
LUKE,2011,MALE,1188,0,1836,10908,13932,81.0
MAKAI,2011,MALE,0,360,0,0,360,533.0
MAKSIM,2011,MALE,0,0,0,396,396,493.0
MALACHI,2011,MALE,0,2592,0,0,2592,173.0
MALCOLM,2011,MALE,0,396,0,0,396,493.0
MALIK,2011,MALE,0,864,0,0,864,299.0
MAMADOU,2011,MALE,0,972,0,0,972,283.0
MANUEL,2011,MALE,0,0,1116,0,1116,263.0
MARC,2011,MALE,0,792,0,1152,1944,209.0
MARCO,2011,MALE,0,0,1584,1152,2736,164.0
MARCOS,2011,MALE,0,0,1044,0,1044,273.0
MARCUS,2011,MALE,2880,3456,4752,2016,13104,84.0
MARIO,2011,MALE,0,0,828,0,828,308.0
MARK,2011,MALE,0,0,1368,5040,6408,112.0
MARLON,2011,MALE,0,0,360,0,360,533.0
MARQUIS,2011,MALE,0,360,0,0,360,533.0
MARTIN,2011,MALE,1512,0,1728,2268,5508,124.0
MARVIN,2011,MALE,0,0,576,0,576,377.0
MASON,2011,MALE,4896,11952,24912,10800,52560,17.0
MATEO,2011,MALE,0,0,3168,1224,4392,137.0
MATHEW,2011,MALE,0,0,684,0,684,340.0
MATIAS,2011,MALE,0,0,720,0,720,328.0
MATTEO,2011,MALE,0,0,0,1080,1080,268.0
MATTHEW,2011,MALE,10656,8496,39744,27216,86112,4.0
MAURICE,2011,MALE,0,576,0,0,576,377.0
MAURICIO,2011,MALE,0,0,432,0,432,467.0
MAX,2011,MALE,1512,0,3564,10260,15336,76.0
MAXIM,2011,MALE,0,0,0,972,972,283.0
MAXIMILIAN,2011,MALE,0,0,0,1044,1044,273.0
MAXIMILIANO,2011,MALE,0,0,468,0,468,439.0
MAXIMO,2011,MALE,0,0,432,0,432,467.0
MAXIMUS,2011,MALE,0,0,1080,1008,2088,200.0
MAXWELL,2011,MALE,0,0,0,1368,1368,239.0
MAYER,2011,MALE,0,0,0,864,864,299.0
MEILECH,2011,MALE,0,0,0,396,396,493.0
MEIR,2011,MALE,0,0,0,1692,1692,224.0
MEKHI,2011,MALE,0,1188,0,0,1188,254.0
MELVIN,2011,MALE,0,0,432,0,432,467.0
MENACHEM,2011,MALE,0,0,0,3708,3708,146.0
MENASHE,2011,MALE,0,0,0,396,396,493.0
MENDEL,2011,MALE,0,0,0,1296,1296,246.0
MENDY,2011,MALE,0,0,0,396,396,493.0
MESSIAH,2011,MALE,0,828,0,0,828,308.0
MICAH,2011,MALE,0,2088,0,864,2952,163.0
MICHAEL,2011,MALE,5472,13392,25056,42048,85968,5.0
MIGUEL,2011,MALE,0,0,3636,0,3636,151.0
MIKE,2011,MALE,0,0,612,0,612,366.0
MILES,2011,MALE,1080,1080,0,4968,7128,110.0
MILO,2011,MALE,0,0,0,720,720,328.0
MOHAMED,2011,MALE,1404,3996,0,4104,9504,99.0
MOHAMMAD,2011,MALE,1656,0,0,0,1656,226.0
MOHAMMED,2011,MALE,4428,2484,0,1080,7992,107.0
MOISES,2011,MALE,0,0,648,0,648,354.0
MOISHE,2011,MALE,0,0,0,648,648,354.0
MORDECHAI,2011,MALE,0,0,0,2736,2736,164.0
MORRIS,2011,MALE,0,0,0,396,396,493.0
MOSES,2011,MALE,0,0,0,1116,1116,263.0
MOSHE,2011,MALE,0,0,0,8064,8064,106.0
MOUSSA,2011,MALE,0,396,0,0,396,493.0
MUHAMMAD,2011,MALE,2736,0,0,0,2736,164.0
MYLES,2011,MALE,0,540,0,0,540,395.0
NAFTALI,2011,MALE,0,0,0,648,648,354.0
NAFTULI,2011,MALE,0,0,0,648,648,354.0
NANA,2011,MALE,0,360,0,0,360,533.0
NASIR,2011,MALE,0,1188,0,0,1188,254.0
NATHAN,2011,MALE,5904,4608,6768,10224,27504,44.0
NATHANIEL,2011,MALE,2304,9216,9072,6624,27216,45.0
NEHEMIAH,2011,MALE,0,468,0,0,468,439.0
NELSON,2011,MALE,864,0,1152,0,2016,204.0
NICHOLAS,2011,MALE,3744,4464,14832,22032,45072,30.0
NICO,2011,MALE,0,0,0,468,468,439.0
NICOLAS,2011,MALE,0,1188,5724,3024,9936,98.0
NIGEL,2011,MALE,0,360,0,0,360,533.0
NIKOLAS,2011,MALE,0,0,0,360,360,533.0
NOAH,2011,MALE,2736,13104,22608,14256,52704,16.0
NOAM,2011,MALE,0,0,0,396,396,493.0
NOEL,2011,MALE,0,0,864,0,864,299.0
NOLAN,2011,MALE,0,0,0,396,396,493.0
NOSSON,2011,MALE,0,0,0,360,360,533.0
OLIVER,2011,MALE,1080,0,4536,10800,16416,70.0
OMAR,2011,MALE,0,1512,4212,3564,9288,100.0
OMARI,2011,MALE,0,684,0,0,684,340.0
OSCAR,2011,MALE,2550,0,2754,2550,7854,108.0
OUSMANE,2011,MALE,0,504,0,0,504,415.0
OWEN,2011,MALE,2916,0,1296,7020,11232,92.0
PABLO,2011,MALE,0,0,900,0,900,294.0
PARKER,2011,MALE,0,0,0,576,576,377.0
PATRICK,2011,MALE,2016,2016,1728,8064,13824,82.0
PAUL,2011,MALE,0,0,1152,1872,3024,162.0
PEDRO,2011,MALE,0,0,1044,0,1044,273.0
PETER,2011,MALE,1188,0,1620,5616,8424,104.0
PHILIP,2011,MALE,0,0,0,936,936,289.0
PINCHAS,2011,MALE,0,0,0,540,540,395.0
PINCHUS,2011,MALE,0,0,0,468,468,439.0
PRESTON,2011,MALE,0,1368,1008,0,2376,185.0
PRINCE,2011,MALE,0,2304,1008,0,3312,157.0
QUINCY,2011,MALE,0,360,0,0,360,533.0
QUINN,2011,MALE,0,0,0,468,468,439.0
RAFAEL,2011,MALE,0,0,2232,1944,4176,139.0
RANDY,2011,MALE,0,0,1728,0,1728,222.0
RAPHAEL,2011,MALE,0,0,0,756,756,318.0
RAYAN,2011,MALE,720,0,0,1152,1872,216.0
RAYMOND,2011,MALE,1944,0,1728,0,3672,147.0
REED,2011,MALE,0,0,0,360,360,533.0
REID,2011,MALE,0,0,0,468,468,439.0
RICARDO,2011,MALE,0,720,1800,0,2520,178.0
RICHARD,2011,MALE,3744,2160,5472,3744,15120,77.0
RICKY,2011,MALE,576,0,0,0,576,377.0
RILEY,2011,MALE,0,0,1296,1008,2304,188.0
ROBERT,2011,MALE,0,3132,3780,7452,14364,79.0
ROBERTO,2011,MALE,0,0,396,0,396,493.0
ROCCO,2011,MALE,0,0,0,684,684,340.0
RODNEY,2011,MALE,0,360,0,0,360,533.0
RODRIGO,2011,MALE,0,0,540,0,540,395.0
ROGER,2011,MALE,0,0,396,0,396,493.0
ROHAN,2011,MALE,540,0,0,0,540,395.0
ROMAN,2011,MALE,0,0,0,432,432,467.0
ROMEO,2011,MALE,0,0,504,0,504,415.0
ROWAN,2011,MALE,0,0,0,432,432,467.0
ROYCE,2011,MALE,0,0,396,0,396,493.0
RUBEN,2011,MALE,0,0,684,0,684,340.0
RYAN,2011,MALE,21600,5904,17568,18144,63216,14.0
RYDER,2011,MALE,0,0,0,576,576,377.0
SALVATORE,2011,MALE,0,0,0,1296,1296,246.0
SAM,2011,MALE,0,0,0,1260,1260,250.0
SAMIR,2011,MALE,0,0,0,360,360,533.0
SAMUEL,2011,MALE,4320,4320,10656,26064,45360,28.0
SANTIAGO,2011,MALE,0,0,1800,0,1800,220.0
SANTINO,2011,MALE,0,0,0,396,396,493.0
SEAN,2011,MALE,2016,4176,4320,5184,15696,75.0
SEBASTIAN,2011,MALE,2016,1584,26352,10224,40176,34.0
SEKOU,2011,MALE,0,540,0,0,540,395.0
SERGIO,2011,MALE,0,0,468,0,468,439.0
SETH,2011,MALE,0,432,0,0,432,467.0
SHALOM,2011,MALE,0,0,0,396,396,493.0
SHANE,2011,MALE,0,0,720,1512,2232,194.0
SHAUL,2011,MALE,0,0,0,360,360,533.0
SHAWN,2011,MALE,1020,1530,1530,0,4080,141.0
SHAYA,2011,MALE,0,0,0,936,936,289.0
SHEA,2011,MALE,0,0,0,576,576,377.0
SHIA,2011,MALE,0,0,0,1080,1080,268.0
SHIMON,2011,MALE,0,0,0,3384,3384,155.0
SHLOIME,2011,MALE,0,0,0,540,540,395.0
SHLOIMY,2011,MALE,0,0,0,468,468,439.0
SHLOME,2011,MALE,0,0,0,612,612,366.0
SHLOMO,2011,MALE,0,0,0,2196,2196,196.0
SHMIEL,2011,MALE,0,0,0,612,612,366.0
SHMUEL,2011,MALE,0,0,0,1584,1584,231.0
SHNEUR,2011,MALE,0,0,0,396,396,493.0
SHOLOM,2011,MALE,0,0,0,756,756,318.0
SHULEM,2011,MALE,0,0,0,1512,1512,233.0
SIDNEY,2011,MALE,0,0,0,360,360,533.0
SILAS,2011,MALE,0,0,0,360,360,533.0
SIMCHA,2011,MALE,0,0,0,1152,1152,259.0
SIMON,2011,MALE,1008,0,0,3384,4392,137.0
SINCERE,2011,MALE,0,864,0,0,864,299.0
SOLOMON,2011,MALE,0,0,0,1728,1728,222.0
SPENCER,2011,MALE,0,0,0,540,540,395.0
STANLEY,2011,MALE,828,0,0,0,828,308.0
STEPHEN,2011,MALE,0,1080,1080,1080,3240,159.0
STEVE,2011,MALE,0,0,360,0,360,533.0
STEVEN,2011,MALE,5040,1728,14976,4608,26352,47.0
SYED,2011,MALE,576,0,0,0,576,377.0
TAYLOR,2011,MALE,0,0,360,0,360,533.0
TENZIN,2011,MALE,864,0,0,0,864,299.0
TERRELL,2011,MALE,0,360,0,0,360,533.0
TERRENCE,2011,MALE,0,396,0,0,396,493.0
TERRY,2011,MALE,396,0,0,0,396,493.0
THEODORE,2011,MALE,0,0,0,1908,1908,213.0
THOMAS,2011,MALE,1944,0,2808,13068,17820,64.0
TIMOTHY,2011,MALE,2304,2016,2304,3456,10080,97.0
TOMAS,2011,MALE,0,0,360,0,360,533.0
TONY,2011,MALE,576,0,0,0,576,377.0
TRAVIS,2011,MALE,1188,1836,1404,0,4428,135.0
TRISTAN,2011,MALE,0,6264,3672,2592,12528,89.0
TROY,2011,MALE,0,468,0,0,468,439.0
TYLER,2011,MALE,4464,14544,6912,8784,34704,37.0
TZVI,2011,MALE,0,0,0,1476,1476,235.0
URIEL,2011,MALE,0,0,756,0,756,318.0
USHER,2011,MALE,0,0,0,1044,1044,273.0
VICTOR,2011,MALE,2448,1728,6912,4896,15984,74.0
VINCENT,2011,MALE,7668,0,1836,6912,16416,70.0
VINCENZO,2011,MALE,0,0,0,468,468,439.0
WESLEY,2011,MALE,0,0,0,360,360,533.0
WILLIAM,2011,MALE,9504,3888,14112,24480,51984,20.0
WILSON,2011,MALE,1656,0,792,0,2448,183.0
WYATT,2011,MALE,0,0,0,900,900,294.0
XAVIER,2011,MALE,1440,8352,13248,2592,25632,49.0
YAAKOV,2011,MALE,0,0,0,1620,1620,229.0
YADIEL,2011,MALE,0,0,900,0,900,294.0
YAHIR,2011,MALE,0,0,576,0,576,377.0
YAIR,2011,MALE,0,0,360,0,360,533.0
YAKOV,2011,MALE,0,0,0,2160,2160,197.0
YANDEL,2011,MALE,0,0,432,0,432,467.0
YANIEL,2011,MALE,0,0,360,0,360,533.0
YARIEL,2011,MALE,0,0,432,0,432,467.0
YASEEN,2011,MALE,0,0,0,396,396,493.0
YECHEZKEL,2011,MALE,0,0,0,396,396,493.0
YECHIEL,2011,MALE,0,0,0,972,972,283.0
YEHOSHUA,2011,MALE,0,0,0,792,792,315.0
YEHUDA,2011,MALE,0,0,0,2664,2664,169.0
YEHUDAH,2011,MALE,0,0,0,360,360,533.0
YERIK,2011,MALE,0,0,468,0,468,439.0
YIDA,2011,MALE,0,0,0,468,468,439.0
YIDEL,2011,MALE,0,0,0,396,396,493.0
YISRAEL,2011,MALE,0,0,0,504,504,415.0
YISROEL,2011,MALE,0,0,0,2700,2700,168.0
YITZCHAK,2011,MALE,0,0,0,612,612,366.0
YITZCHOK,2011,MALE,0,0,0,2016,2016,204.0
YOEL,2011,MALE,0,0,0,720,720,328.0
YONAH,2011,MALE,0,0,0,360,360,533.0
YOSEF,2011,MALE,0,0,0,3672,3672,147.0
YOUSEF,2011,MALE,0,0,0,432,432,467.0
YOUSSEF,2011,MALE,0,0,0,396,396,493.0
ZACHARY,2011,MALE,1728,3168,2304,12384,19584,59.0
ZAIN,2011,MALE,432,0,0,0,432,467.0
ZAIRE,2011,MALE,0,684,0,0,684,340.0
ZALMEN,2011,MALE,0,0,0,504,504,415.0
ZAYAN,2011,MALE,360,0,0,0,360,533.0
ZEV,2011,MALE,0,0,0,1692,1692,224.0
ZION,2011,MALE,0,2520,936,0,3456,154.0
ZYAIRE,2011,MALE,0,504,0,0,504,415.0
AALIYAH,2012,FEMALE,0,3960,4896,0,8856,80.0
ABBY,2012,FEMALE,396,0,0,0,396,550.0
ABIGAIL,2012,FEMALE,4002,9108,13662,12995,39767,12.0
ADA,2012,FEMALE,864,0,0,1008,1872,218.0
ADDISON,2012,FEMALE,0,0,0,1152,1152,272.0
ADELAIDE,2012,FEMALE,0,0,0,684,684,360.0
ADELE,2012,FEMALE,0,0,0,540,540,427.0
ADINA,2012,FEMALE,0,0,0,720,720,344.0
ADRIANA,2012,FEMALE,0,0,4248,3096,7344,94.0
ADRIANNA,2012,FEMALE,0,1188,2160,2484,5832,108.0
AHUVA,2012,FEMALE,0,0,0,540,540,427.0
AICHA,2012,FEMALE,0,504,0,0,504,457.0
AILEEN,2012,FEMALE,0,0,972,0,972,296.0
AISHA,2012,FEMALE,792,1368,0,0,2160,205.0
AISSATOU,2012,FEMALE,0,468,0,0,468,485.0
ALANA,2012,FEMALE,0,2700,1944,1296,5940,107.0
ALANI,2012,FEMALE,0,936,1008,0,1944,210.0
ALEJANDRA,2012,FEMALE,0,0,504,0,504,457.0
ALESSANDRA,2012,FEMALE,0,0,1224,1080,2304,200.0
ALESSIA,2012,FEMALE,0,0,0,400,400,548.0
ALEXA,2012,FEMALE,0,1224,6732,4760,12716,56.0
ALEXANDRA,2012,FEMALE,1020,0,4182,11220,16422,39.0
ALEXANDRIA,2012,FEMALE,0,0,0,360,360,588.0
ALEXIA,2012,FEMALE,0,0,432,0,432,521.0
ALEXIS,2012,FEMALE,1944,1296,0,2484,5724,111.0
ALICE,2012,FEMALE,3996,0,2376,5832,12204,61.0
ALICIA,2012,FEMALE,0,1080,1296,0,2376,198.0
ALINA,2012,FEMALE,3240,0,1944,1728,6912,101.0
ALISA,2012,FEMALE,0,0,0,432,432,521.0
ALISHA,2012,FEMALE,468,0,0,0,468,485.0
ALISON,2012,FEMALE,0,0,1152,0,1152,272.0
ALISSON,2012,FEMALE,0,0,400,0,400,548.0
ALIYAH,2012,FEMALE,0,1440,1224,0,2664,187.0
ALIZA,2012,FEMALE,0,0,0,720,720,344.0
ALLISON,2012,FEMALE,1728,0,9288,1728,12744,55.0
ALLYSON,2012,FEMALE,0,0,648,0,648,375.0
ALMA,2012,FEMALE,0,0,0,360,360,588.0
ALONDRA,2012,FEMALE,0,0,425,0,425,547.0
ALYSSA,2012,FEMALE,2592,4320,6912,3168,16992,38.0
AMALIA,2012,FEMALE,0,0,720,792,1512,250.0
AMANDA,2012,FEMALE,3036,1518,5796,1955,12305,60.0
AMAYA,2012,FEMALE,1188,3996,3888,0,9072,79.0
AMBER,2012,FEMALE,2052,1080,2700,0,5832,108.0
AMBERLY,2012,FEMALE,0,0,396,0,396,550.0
AMELIA,2012,FEMALE,2880,2304,6048,12384,23616,30.0
AMELIE,2012,FEMALE,0,0,792,792,1584,244.0
AMINA,2012,FEMALE,1944,1188,0,1728,4860,126.0
AMINATA,2012,FEMALE,0,720,0,0,720,344.0
AMIRA,2012,FEMALE,0,1056,0,715,1771,230.0
AMIRAH,2012,FEMALE,0,972,0,0,972,296.0
AMIYAH,2012,FEMALE,0,504,0,0,504,457.0
AMY,2012,FEMALE,2346,0,6936,1105,10387,74.0
ANA,2012,FEMALE,0,0,1368,0,1368,256.0
ANAIS,2012,FEMALE,0,0,360,0,360,588.0
ANALIA,2012,FEMALE,0,0,540,0,540,427.0
ANASTASIA,2012,FEMALE,0,0,0,684,684,360.0
ANAYA,2012,FEMALE,300,0,0,0,300,637.0
ANDREA,2012,FEMALE,0,0,1764,0,1764,231.0
ANGEL,2012,FEMALE,1008,1008,0,0,2016,209.0
ANGELA,2012,FEMALE,3744,0,1872,0,5616,113.0
ANGELICA,2012,FEMALE,0,0,684,0,684,360.0
ANGELINA,2012,FEMALE,2346,1495,8142,6624,18607,35.0
ANGELIQUE,2012,FEMALE,0,0,936,0,936,299.0
ANGIE,2012,FEMALE,0,0,500,0,500,483.0
ANISHA,2012,FEMALE,504,0,0,0,504,457.0
ANIYA,2012,FEMALE,0,396,0,0,396,550.0
ANIYAH,2012,FEMALE,0,2160,1008,0,3168,173.0
ANNA,2012,FEMALE,4212,0,1080,9720,15012,45.0
ANNABEL,2012,FEMALE,0,0,0,396,396,550.0
ANNABELLE,2012,FEMALE,864,0,0,1008,1872,218.0
ANNE,2012,FEMALE,0,0,0,432,432,521.0
ANNIE,2012,FEMALE,900,0,0,0,900,302.0
ANTONIA,2012,FEMALE,0,0,0,432,432,521.0
ANYA,2012,FEMALE,684,0,0,0,684,360.0
APRIL,2012,FEMALE,0,0,540,0,540,427.0
ARELY,2012,FEMALE,0,0,432,0,432,521.0
ARIA,2012,FEMALE,3168,2736,1728,2448,10080,76.0
ARIANA,2012,FEMALE,2484,2622,8694,3335,17135,37.0
ARIANNA,2012,FEMALE,3024,5472,11088,4176,23760,28.0
ARIEL,2012,FEMALE,1728,5184,2304,1584,10800,69.0
ARIELLA,2012,FEMALE,0,0,0,700,700,359.0
ARIELLE,2012,FEMALE,0,2484,1080,1728,5292,120.0
ARISHA,2012,FEMALE,396,0,0,0,396,550.0
ARYA,2012,FEMALE,468,0,0,0,468,485.0
ASHLEY,2012,FEMALE,6480,2448,22896,4176,36000,13.0
ATHENA,2012,FEMALE,1080,0,1836,1296,4212,143.0
AUBREE,2012,FEMALE,0,504,0,0,504,457.0
AUBREY,2012,FEMALE,0,2754,2210,1020,5984,106.0
AUDREY,2012,FEMALE,2520,0,0,2736,5256,121.0
AURORA,2012,FEMALE,0,0,396,0,396,550.0
AUTUMN,2012,FEMALE,0,725,0,0,725,343.0
AVA,2012,FEMALE,6486,6624,10488,18975,42573,11.0
AVERY,2012,FEMALE,2268,0,1836,8208,12312,58.0
AVIGAIL,2012,FEMALE,0,0,0,325,325,635.0
AVIVA,2012,FEMALE,0,0,0,432,432,521.0
AVRIL,2012,FEMALE,0,0,396,0,396,550.0
AWA,2012,FEMALE,0,360,0,0,360,588.0
AYA,2012,FEMALE,0,0,0,396,396,550.0
AYANNA,2012,FEMALE,0,468,0,0,468,485.0
AYESHA,2012,FEMALE,684,0,0,0,684,360.0
AYLA,2012,FEMALE,0,0,0,648,648,375.0
AYLIN,2012,FEMALE,0,0,720,0,720,344.0
BAILA,2012,FEMALE,0,0,0,1620,1620,242.0
BATSHEVA,2012,FEMALE,0,0,0,2052,2052,207.0
BEATRICE,2012,FEMALE,0,0,0,1044,1044,287.0
BELLA,2012,FEMALE,2622,1932,5290,3036,12880,54.0
BIANCA,2012,FEMALE,0,0,1584,720,2304,200.0
BINTOU,2012,FEMALE,0,396,0,0,396,550.0
BLIMA,2012,FEMALE,0,0,0,1332,1332,258.0
BLIMY,2012,FEMALE,0,0,0,756,756,336.0
BONNIE,2012,FEMALE,432,0,0,0,432,521.0
BRACHA,2012,FEMALE,0,0,0,1188,1188,270.0
BREINDY,2012,FEMALE,0,0,0,432,432,521.0
BRENDA,2012,FEMALE,0,0,432,0,432,521.0
BRIANA,2012,FEMALE,0,0,1224,0,1224,265.0
BRIANNA,2012,FEMALE,1440,4608,15120,3456,24624,26.0
BRIELLE,2012,FEMALE,0,3024,1224,0,4248,140.0
BRITNEY,2012,FEMALE,0,0,540,0,540,427.0
BRITTANY,2012,FEMALE,0,0,756,0,756,336.0
BROOKE,2012,FEMALE,0,0,0,936,936,299.0
BRUCHY,2012,FEMALE,0,0,0,756,756,336.0
BRYANNA,2012,FEMALE,0,0,576,0,576,408.0
CAITLIN,2012,FEMALE,0,0,0,360,360,588.0
CAMILA,2012,FEMALE,0,0,5796,0,5796,110.0
CAMILLA,2012,FEMALE,0,0,432,0,432,521.0
CAMILLE,2012,FEMALE,0,360,0,0,360,588.0
CARMEN,2012,FEMALE,0,0,684,0,684,360.0
CAROLINA,2012,FEMALE,0,0,936,720,1656,236.0
CAROLINE,2012,FEMALE,1188,0,1512,5184,7884,89.0
CASSANDRA,2012,FEMALE,0,0,0,360,360,588.0
CATALINA,2012,FEMALE,0,0,900,0,900,302.0
CATHERINE,2012,FEMALE,2808,0,1620,3564,7992,88.0
CECILIA,2012,FEMALE,864,0,0,2016,2880,180.0
CELIA,2012,FEMALE,0,0,0,396,396,550.0
CHANA,2012,FEMALE,0,0,0,5580,5580,116.0
CHANIE,2012,FEMALE,0,0,0,360,360,588.0
CHANY,2012,FEMALE,0,0,0,1584,1584,244.0
CHARLOTTE,2012,FEMALE,2244,0,1020,12852,16116,40.0
CHAVA,2012,FEMALE,0,0,0,1368,1368,256.0
CHAVY,2012,FEMALE,0,0,0,504,504,457.0
CHAYA,2012,FEMALE,0,0,0,6264,6264,105.0
CHELSEA,2012,FEMALE,2592,4176,6480,2016,15264,44.0
CHEYENNE,2012,FEMALE,0,360,0,0,360,588.0
CHLOE,2012,FEMALE,23736,8050,7866,13248,52900,8.0
CHRISTINA,2012,FEMALE,2592,2016,1440,2160,8208,86.0
CHRISTINE,2012,FEMALE,504,0,0,0,504,457.0
CINDY,2012,FEMALE,1080,0,792,0,1872,218.0
CLAIRE,2012,FEMALE,1944,0,0,3240,5184,122.0
CLARA,2012,FEMALE,0,0,0,1512,1512,250.0
COLETTE,2012,FEMALE,0,0,0,612,612,388.0
CONNIE,2012,FEMALE,540,0,0,0,540,427.0
CORA,2012,FEMALE,0,0,0,612,612,388.0
CRYSTAL,2012,FEMALE,1224,0,1224,0,2448,196.0
CYNTHIA,2012,FEMALE,1368,0,864,0,2232,202.0
DAHLIA,2012,FEMALE,0,0,0,540,540,427.0
DAISY,2012,FEMALE,0,0,1800,792,2592,189.0
DALIA,2012,FEMALE,0,0,0,396,396,550.0
DANA,2012,FEMALE,0,0,504,0,504,457.0
DANIELA,2012,FEMALE,0,0,4320,720,5040,123.0
DANIELLA,2012,FEMALE,0,0,1512,2448,3960,148.0
DANIELLE,2012,FEMALE,0,720,0,936,1656,236.0
DANNA,2012,FEMALE,0,0,1152,0,1152,272.0
DAPHNE,2012,FEMALE,792,0,0,1152,1944,210.0
DAYANA,2012,FEMALE,0,0,1044,0,1044,287.0
DEBORAH,2012,FEMALE,0,360,0,0,360,588.0
DELILAH,2012,FEMALE,0,0,900,0,900,302.0
DENISE,2012,FEMALE,0,0,360,0,360,588.0
DESTINY,2012,FEMALE,0,2090,2640,0,4730,128.0
DEVORA,2012,FEMALE,0,0,0,576,576,408.0
DEVORAH,2012,FEMALE,0,0,0,1332,1332,258.0
DIANA,2012,FEMALE,0,0,3024,1440,4464,135.0
DINA,2012,FEMALE,0,0,0,1584,1584,244.0
DIYA,2012,FEMALE,396,0,0,0,396,550.0
DORIS,2012,FEMALE,468,0,0,0,468,485.0
DULCE,2012,FEMALE,0,0,360,0,360,588.0
DYLAN,2012,FEMALE,0,0,0,828,828,316.0
EDEN,2012,FEMALE,0,0,0,650,650,374.0
EILEEN,2012,FEMALE,1080,0,792,0,1872,218.0
ELAINE,2012,FEMALE,756,0,0,0,756,336.0
ELEANOR,2012,FEMALE,1080,0,0,3240,4320,138.0
ELENA,2012,FEMALE,1188,0,3024,2160,6372,104.0
ELIANA,2012,FEMALE,0,0,1870,2838,4708,129.0
ELIANNY,2012,FEMALE,0,0,360,0,360,588.0
ELINA,2012,FEMALE,504,0,0,0,504,457.0
ELISA,2012,FEMALE,0,0,396,0,396,550.0
ELISE,2012,FEMALE,0,720,0,1008,1728,232.0
ELISHEVA,2012,FEMALE,0,0,0,612,612,388.0
ELIZA,2012,FEMALE,0,0,0,648,648,375.0
ELIZABETH,2012,FEMALE,4464,4464,9936,16704,35568,14.0
ELLA,2012,FEMALE,5616,0,2052,15984,23652,29.0
ELLE,2012,FEMALE,0,0,0,720,720,344.0
ELLIANA,2012,FEMALE,0,0,0,396,396,550.0
ELLIE,2012,FEMALE,1224,0,0,1656,2880,180.0
ELOISE,2012,FEMALE,0,0,0,1116,1116,280.0
ELSA,2012,FEMALE,0,0,0,504,504,457.0
EMELY,2012,FEMALE,0,0,2556,0,2556,190.0
EMERSON,2012,FEMALE,0,0,0,396,396,550.0
EMILIA,2012,FEMALE,0,0,1296,3168,4464,135.0
EMILY,2012,FEMALE,15180,4830,21390,18906,60306,4.0
EMMA,2012,FEMALE,11155,3726,17250,31464,63595,2.0
ERICA,2012,FEMALE,828,0,0,0,828,316.0
ERIKA,2012,FEMALE,0,0,396,0,396,550.0
ERIN,2012,FEMALE,1152,792,0,0,1944,210.0
ESME,2012,FEMALE,0,0,0,576,576,408.0
ESMERALDA,2012,FEMALE,0,0,864,0,864,311.0
ESTELLE,2012,FEMALE,0,0,0,396,396,550.0
ESTER,2012,FEMALE,0,0,0,396,396,550.0
ESTHER,2012,FEMALE,1728,0,1404,20736,23868,27.0
ESTY,2012,FEMALE,0,0,0,432,432,521.0
ETTY,2012,FEMALE,0,0,0,684,684,360.0
EVA,2012,FEMALE,3024,0,4536,6912,14472,48.0
EVANGELINE,2012,FEMALE,0,0,720,1080,1800,225.0
EVE,2012,FEMALE,0,0,0,468,468,485.0
EVELYN,2012,FEMALE,3996,0,5076,5616,14688,47.0
FAIGA,2012,FEMALE,0,0,0,1044,1044,287.0
FAIGY,2012,FEMALE,0,0,0,2520,2520,192.0
FAITH,2012,FEMALE,1440,6048,3024,1440,11952,65.0
FANTA,2012,FEMALE,0,576,0,0,576,408.0
FATIMA,2012,FEMALE,4752,4176,2304,1728,12960,53.0
FATOUMATA,2012,FEMALE,0,1656,0,0,1656,236.0
FERNANDA,2012,FEMALE,0,0,360,0,360,588.0
FIONA,2012,FEMALE,3528,0,0,2088,5616,113.0
FRADY,2012,FEMALE,0,0,0,396,396,550.0
FRAIDY,2012,FEMALE,0,0,0,648,648,375.0
FRANCES,2012,FEMALE,0,0,0,468,468,485.0
FRANCESCA,2012,FEMALE,0,0,0,1188,1188,270.0
FRIMET,2012,FEMALE,0,0,0,468,468,485.0
GABRIELA,2012,FEMALE,0,0,4608,720,5328,118.0
GABRIELLA,2012,FEMALE,2160,3600,11376,12384,29520,20.0
GABRIELLE,2012,FEMALE,0,2772,0,935,3707,155.0
GEMMA,2012,FEMALE,0,0,0,792,792,326.0
GENESIS,2012,FEMALE,0,1512,8424,0,9936,77.0
GENEVIEVE,2012,FEMALE,0,0,0,648,648,375.0
GEORGIA,2012,FEMALE,0,0,0,576,576,408.0
GERALDINE,2012,FEMALE,0,0,396,0,396,550.0
GIA,2012,FEMALE,0,0,864,2592,3456,160.0
GIADA,2012,FEMALE,0,0,0,468,468,485.0
GIANNA,2012,FEMALE,0,1836,5184,5184,12204,61.0
GISELLE,2012,FEMALE,0,0,1440,0,1440,254.0
GITTEL,2012,FEMALE,0,0,0,756,756,336.0
GITTY,2012,FEMALE,0,0,0,2484,2484,195.0
GIULIA,2012,FEMALE,0,0,0,432,432,521.0
GIULIANA,2012,FEMALE,0,0,0,1512,1512,250.0
GOLDA,2012,FEMALE,0,0,0,468,468,485.0
GOLDY,2012,FEMALE,0,0,0,900,900,302.0
GRACE,2012,FEMALE,7344,2880,4320,11376,25920,23.0
GRETA,2012,FEMALE,0,0,0,468,468,485.0
GUADALUPE,2012,FEMALE,0,0,1224,0,1224,265.0
HADASSAH,2012,FEMALE,0,0,0,360,360,588.0
HADLEY,2012,FEMALE,0,0,0,468,468,485.0
HAFSA,2012,FEMALE,396,0,0,0,396,550.0
HAILEY,2012,FEMALE,6900,3864,13110,4140,28014,21.0
HALEY,2012,FEMALE,0,0,612,0,612,388.0
HANA,2012,FEMALE,0,0,0,468,468,485.0
HANNA,2012,FEMALE,0,0,0,828,828,316.0
HANNAH,2012,FEMALE,6624,3168,4320,11952,26064,22.0
HAREEM,2012,FEMALE,396,0,0,0,396,550.0
HARMONY,2012,FEMALE,0,550,0,0,550,426.0
HARPER,2012,FEMALE,0,0,0,1548,1548,248.0
HAWA,2012,FEMALE,0,468,0,0,468,485.0
HAYLEE,2012,FEMALE,0,0,360,0,360,588.0
HAZEL,2012,FEMALE,1080,0,1620,1728,4428,137.0
HEAVEN,2012,FEMALE,0,1800,1224,0,3024,174.0
HEIDI,2012,FEMALE,0,0,360,0,360,588.0
HEIDY,2012,FEMALE,0,0,468,0,468,485.0
HELEN,2012,FEMALE,1296,0,1404,1512,4212,143.0
HELENA,2012,FEMALE,0,0,0,540,540,427.0
HENNY,2012,FEMALE,0,0,0,504,504,457.0
HINDA,2012,FEMALE,0,0,0,540,540,427.0
HINDY,2012,FEMALE,0,0,0,1440,1440,254.0
IDY,2012,FEMALE,0,0,0,540,540,427.0
IMANI,2012,FEMALE,0,1224,0,0,1224,265.0
INES,2012,FEMALE,0,0,0,360,360,588.0
IRENE,2012,FEMALE,828,0,0,0,828,316.0
IRIS,2012,FEMALE,1386,0,0,825,2211,204.0
ISABEL,2012,FEMALE,0,0,2880,1728,4608,130.0
ISABELA,2012,FEMALE,0,0,468,0,468,485.0
ISABELLA,2012,FEMALE,6720,5418,34335,12915,59388,6.0
ISABELLE,2012,FEMALE,1224,0,0,1512,2736,183.0
ISLA,2012,FEMALE,0,0,0,792,792,326.0
ITZEL,2012,FEMALE,0,0,792,0,792,326.0
IVANNA,2012,FEMALE,0,0,432,0,432,521.0
IVY,2012,FEMALE,2310,0,0,935,3245,167.0
IZABELLA,2012,FEMALE,0,0,828,0,828,316.0
JACQUELINE,2012,FEMALE,0,0,2160,1872,4032,147.0
JADA,2012,FEMALE,0,2016,936,0,2952,177.0
JADE,2012,FEMALE,0,3456,6156,1188,10800,69.0
JAELYN,2012,FEMALE,0,0,360,0,360,588.0
JALIYAH,2012,FEMALE,0,576,0,0,576,408.0
JAMIE,2012,FEMALE,0,0,612,0,612,388.0
JANA,2012,FEMALE,0,0,0,576,576,408.0
JANE,2012,FEMALE,0,0,0,720,720,344.0
JANELLE,2012,FEMALE,0,612,0,0,612,388.0
JANICE,2012,FEMALE,504,0,0,0,504,457.0
JANIYAH,2012,FEMALE,0,540,0,0,540,427.0
JANNAT,2012,FEMALE,648,0,0,0,648,375.0
JASMIN,2012,FEMALE,0,0,360,0,360,588.0
JASMINE,2012,FEMALE,3744,3888,4320,1440,13392,50.0
JAYDA,2012,FEMALE,0,432,0,0,432,521.0
JAYLA,2012,FEMALE,0,1800,1728,0,3528,158.0
JAYLAH,2012,FEMALE,0,0,648,0,648,375.0
JAYLEEN,2012,FEMALE,0,0,1296,0,1296,262.0
JAYLENE,2012,FEMALE,0,0,864,0,864,311.0
JAYLIN,2012,FEMALE,0,0,540,0,540,427.0
JAZLYN,2012,FEMALE,0,0,792,0,792,326.0
JAZMIN,2012,FEMALE,0,0,540,0,540,427.0
JAZMINE,2012,FEMALE,0,0,375,0,375,587.0
JAZZLYN,2012,FEMALE,0,0,360,0,360,588.0
JENNA,2012,FEMALE,0,0,0,612,612,388.0
JENNIFER,2012,FEMALE,2484,0,6480,1404,10368,75.0
JENNY,2012,FEMALE,936,0,0,0,936,299.0
JESSICA,2012,FEMALE,5760,1584,3888,2448,13680,49.0
JIMENA,2012,FEMALE,0,0,468,0,468,485.0
JOANNA,2012,FEMALE,2664,0,0,792,3456,160.0
JOCELYN,2012,FEMALE,1368,0,2808,0,4176,145.0
JOHANNA,2012,FEMALE,0,0,576,0,576,408.0
JOLIE,2012,FEMALE,0,0,0,396,396,550.0
JOLIN,2012,FEMALE,360,0,0,0,360,588.0
JORDAN,2012,FEMALE,0,720,0,864,1584,244.0
JORDYN,2012,FEMALE,0,684,0,0,684,360.0
JOSELYN,2012,FEMALE,0,0,828,0,828,316.0
JOSEPHINE,2012,FEMALE,0,0,0,1224,1224,265.0
JOY,2012,FEMALE,504,0,0,0,504,457.0
JOYCE,2012,FEMALE,2016,0,0,720,2736,183.0
JUDY,2012,FEMALE,720,0,0,936,1656,236.0
JULIA,2012,FEMALE,850,0,2040,9282,12172,63.0
JULIANA,2012,FEMALE,0,0,1008,2304,3312,165.0
JULIANNA,2012,FEMALE,0,0,1008,1224,2232,202.0
JULIE,2012,FEMALE,0,0,720,1224,1944,210.0
JULIET,2012,FEMALE,0,0,1452,2090,3542,157.0
JULIETTE,2012,FEMALE,0,0,1320,1375,2695,186.0
JULISSA,2012,FEMALE,0,0,576,0,576,408.0
JUNE,2012,FEMALE,0,0,0,432,432,521.0
KAILEY,2012,FEMALE,0,0,612,0,612,388.0
KAITLYN,2012,FEMALE,2880,2016,4464,2304,11664,66.0
KALIYAH,2012,FEMALE,0,360,0,0,360,588.0
KAMILA,2012,FEMALE,0,0,1044,0,1044,287.0
KAREN,2012,FEMALE,936,0,2016,0,2952,177.0
KARINA,2012,FEMALE,0,0,396,0,396,550.0
KARLA,2012,FEMALE,0,0,684,0,684,360.0
KASSANDRA,2012,FEMALE,0,0,468,0,468,485.0
KATE,2012,FEMALE,935,0,0,1122,2057,206.0
KATELYN,2012,FEMALE,1296,0,2268,1296,4860,126.0
KATHERINE,2012,FEMALE,3774,0,3774,3485,11033,68.0
KATHRYN,2012,FEMALE,0,0,0,612,612,388.0
KATIE,2012,FEMALE,1224,0,1105,1224,3553,156.0
KAYA,2012,FEMALE,0,0,0,360,360,588.0
KAYLA,2012,FEMALE,2448,8928,8352,5472,25200,24.0
KAYLEE,2012,FEMALE,3312,3450,12696,1380,20838,32.0
KAYLIE,2012,FEMALE,0,0,468,0,468,485.0
KAYLIN,2012,FEMALE,0,0,360,0,360,588.0
KEIRA,2012,FEMALE,0,0,0,864,864,311.0
KELLY,2012,FEMALE,936,0,1512,0,2448,196.0
KELSEY,2012,FEMALE,0,1152,792,0,1944,210.0
KENNEDY,2012,FEMALE,0,900,0,0,900,302.0
KEYLA,2012,FEMALE,0,0,504,0,504,457.0
KHLOE,2012,FEMALE,1296,5292,5400,0,11988,64.0
KIARA,2012,FEMALE,0,936,1800,0,2736,183.0
KIMBERLY,2012,FEMALE,936,0,6120,0,7056,98.0
KIMORA,2012,FEMALE,0,828,0,0,828,316.0
KIRA,2012,FEMALE,0,0,0,325,325,635.0
KYLA,2012,FEMALE,0,540,0,0,540,427.0
KYLEE,2012,FEMALE,0,540,0,0,540,427.0
KYLIE,2012,FEMALE,1620,3348,3780,0,8748,81.0
LAILA,2012,FEMALE,0,3876,2550,1938,8364,84.0
LANA,2012,FEMALE,0,0,0,504,504,457.0
LARA,2012,FEMALE,0,0,0,576,576,408.0
LAURA,2012,FEMALE,0,0,792,1008,1800,225.0
LAUREN,2012,FEMALE,1728,4608,2592,3600,12528,57.0
LAYLA,2012,FEMALE,1794,2760,5405,5934,15893,42.0
LEA,2012,FEMALE,0,0,0,828,828,316.0
LEAH,2012,FEMALE,2304,5040,14832,31536,53712,7.0
LEILA,2012,FEMALE,0,0,1944,2160,4104,146.0
LEILANI,2012,FEMALE,0,1224,2520,0,3744,154.0
LENA,2012,FEMALE,0,0,0,540,540,427.0
LEORA,2012,FEMALE,0,0,0,468,468,485.0
LESLEY,2012,FEMALE,0,0,360,0,360,588.0
LESLIE,2012,FEMALE,0,0,1224,0,1224,265.0
LESLY,2012,FEMALE,0,0,540,0,540,427.0
LIA,2012,FEMALE,0,0,2160,1368,3528,158.0
LIANA,2012,FEMALE,0,0,720,936,1656,236.0
LIBA,2012,FEMALE,0,0,0,468,468,485.0
LIBBY,2012,FEMALE,0,0,0,864,864,311.0
LILA,2012,FEMALE,0,0,0,1800,1800,225.0
LILAH,2012,FEMALE,0,0,0,468,468,485.0
LILIANA,2012,FEMALE,0,0,1512,1728,3240,168.0
LILLIAN,2012,FEMALE,1152,0,0,3096,4248,140.0
LILLY,2012,FEMALE,0,0,0,684,684,360.0
LILY,2012,FEMALE,2530,1656,2346,14352,20884,31.0
LINA,2012,FEMALE,0,0,0,432,432,521.0
LINDA,2012,FEMALE,612,0,0,0,612,388.0
LITZY,2012,FEMALE,0,0,1044,0,1044,287.0
LIV,2012,FEMALE,0,0,0,360,360,588.0
LIVIA,2012,FEMALE,0,0,0,504,504,457.0
LIZ,2012,FEMALE,0,0,360,0,360,588.0
LIZBETH,2012,FEMALE,0,0,900,0,900,302.0
LOLA,2012,FEMALE,0,0,0,540,540,427.0
LONDON,2012,FEMALE,0,4785,2442,0,7227,96.0
LONDYN,2012,FEMALE,0,720,0,0,720,344.0
LOUISA,2012,FEMALE,0,0,0,576,576,408.0
LUCIA,2012,FEMALE,0,0,936,2304,3240,168.0
LUCY,2012,FEMALE,0,0,0,1944,1944,210.0
LUNA,2012,FEMALE,0,0,1116,0,1116,280.0
LUZ,2012,FEMALE,0,0,720,0,720,344.0
LYDIA,2012,FEMALE,468,0,0,0,468,485.0
LYLA,2012,FEMALE,0,0,0,396,396,550.0
LYRIC,2012,FEMALE,0,576,0,0,576,408.0
MACKENZIE,2012,FEMALE,0,2160,1188,2376,5724,111.0
MADELEINE,2012,FEMALE,720,0,0,2520,3240,168.0
MADELINE,2012,FEMALE,0,0,1008,3960,4968,125.0
MADELYN,2012,FEMALE,0,0,726,1155,1881,217.0
MADISON,2012,FEMALE,2760,18285,19320,9108,49473,9.0
MAE,2012,FEMALE,0,0,0,360,360,588.0
MAEVE,2012,FEMALE,0,0,0,756,756,336.0
MAGGIE,2012,FEMALE,576,0,0,0,576,408.0
MAKAYLA,2012,FEMALE,0,3816,1512,0,5328,118.0
MAKENZIE,2012,FEMALE,0,396,0,0,396,550.0
MALAK,2012,FEMALE,0,0,0,648,648,375.0
MALIA,2012,FEMALE,0,756,0,0,756,336.0
MALIYAH,2012,FEMALE,0,504,0,0,504,457.0
MALKA,2012,FEMALE,0,0,0,2052,2052,207.0
MALKY,2012,FEMALE,0,0,0,2340,2340,199.0
MANDY,2012,FEMALE,540,0,0,0,540,427.0
MANHA,2012,FEMALE,540,0,0,0,540,427.0
MARGARET,2012,FEMALE,0,0,0,1044,1044,287.0
MARGOT,2012,FEMALE,0,0,0,396,396,550.0
MARIA,2012,FEMALE,0,0,3960,3168,7128,97.0
MARIAH,2012,FEMALE,0,1584,1800,0,3384,163.0
MARIAM,2012,FEMALE,0,2448,0,1440,3888,151.0
MARIAMA,2012,FEMALE,0,600,0,0,600,407.0
MARIANA,2012,FEMALE,0,0,396,0,396,550.0
MARILYN,2012,FEMALE,0,0,275,0,275,639.0
MARINA,2012,FEMALE,0,0,0,360,360,588.0
MARY,2012,FEMALE,0,0,0,828,828,316.0
MARYAM,2012,FEMALE,936,0,0,720,1656,236.0
MATILDA,2012,FEMALE,0,0,0,540,540,427.0
MAYA,2012,FEMALE,4032,4176,5616,17280,31104,18.0
MCKENZIE,2012,FEMALE,0,1584,936,0,2520,192.0
MEGAN,2012,FEMALE,2052,1188,1080,0,4320,138.0
MELANIE,2012,FEMALE,1518,3174,12305,1380,18377,36.0
MELANY,2012,FEMALE,0,0,1080,0,1080,285.0
MELINA,2012,FEMALE,0,0,432,0,432,521.0
MELISSA,2012,FEMALE,0,0,3672,936,4608,130.0
MELODY,2012,FEMALE,2808,1512,3240,0,7560,92.0
MIA,2012,FEMALE,7056,5904,29808,19584,62352,3.0
MIAH,2012,FEMALE,0,0,396,0,396,550.0
MICHAELA,2012,FEMALE,0,0,0,468,468,485.0
MICHELLE,2012,FEMALE,6912,2016,6048,5472,20448,33.0
MIKAELA,2012,FEMALE,0,0,504,0,504,457.0
MIKAYLA,2012,FEMALE,0,1836,1404,1296,4536,133.0
MILA,2012,FEMALE,1512,0,2808,4320,8640,83.0
MILAGROS,2012,FEMALE,0,0,360,0,360,588.0
MILAN,2012,FEMALE,0,828,0,0,828,316.0
MILEY,2012,FEMALE,0,0,612,0,612,388.0
MINDY,2012,FEMALE,0,0,0,1080,1080,285.0
MIRACLE,2012,FEMALE,0,648,0,0,648,375.0
MIRANDA,2012,FEMALE,792,0,1152,0,1944,210.0
MIREL,2012,FEMALE,0,0,0,504,504,457.0
MIRI,2012,FEMALE,0,0,0,468,468,485.0
MIRIAM,2012,FEMALE,0,0,720,10800,11520,67.0
MOLLY,2012,FEMALE,0,0,0,1620,1620,242.0
MORGAN,2012,FEMALE,0,1584,0,1210,2794,182.0
MYA,2012,FEMALE,0,1512,2376,0,3888,151.0
NAOMI,2012,FEMALE,0,3564,3780,3240,10584,73.0
NATALIA,2012,FEMALE,0,0,2592,1224,3816,153.0
NATALIE,2012,FEMALE,3132,0,4212,4968,12312,58.0
NATALY,2012,FEMALE,0,0,540,0,540,427.0
NATASHA,2012,FEMALE,0,0,864,0,864,311.0
NATHALIA,2012,FEMALE,0,0,360,0,360,588.0
NATHALIE,2012,FEMALE,0,0,684,0,684,360.0
NATHALY,2012,FEMALE,0,0,576,0,576,408.0
NAYELI,2012,FEMALE,0,0,792,0,792,326.0
NECHAMA,2012,FEMALE,0,0,0,900,900,302.0
NEVAEH,2012,FEMALE,0,4104,1512,0,5616,113.0
NIA,2012,FEMALE,0,1152,0,0,1152,272.0
NICOLE,2012,FEMALE,3456,0,6264,5184,14904,46.0
NICOLETTE,2012,FEMALE,0,0,0,504,504,457.0
NINA,2012,FEMALE,1224,0,0,3024,4248,140.0
NOA,2012,FEMALE,0,0,0,1008,1008,295.0
NOEMI,2012,FEMALE,0,0,468,0,468,485.0
NOOR,2012,FEMALE,0,0,0,432,432,521.0
NORA,2012,FEMALE,0,0,0,1152,1152,272.0
NYLA,2012,FEMALE,0,1692,0,0,1692,234.0
NYLAH,2012,FEMALE,0,2232,1152,0,3384,163.0
OLIVE,2012,FEMALE,0,0,0,648,648,375.0
OLIVIA,2012,FEMALE,18216,8004,10626,22770,59616,5.0
OUMOU,2012,FEMALE,0,468,0,0,468,485.0
PAIGE,2012,FEMALE,0,1800,0,1152,2952,177.0
PAOLA,2012,FEMALE,0,0,468,0,468,485.0
PARIS,2012,FEMALE,0,2088,1152,0,3240,168.0
PAULA,2012,FEMALE,0,0,360,0,360,588.0
PEARL,2012,FEMALE,0,0,0,1116,1116,280.0
PENELOPE,2012,FEMALE,1080,0,1836,5832,8748,81.0
PEREL,2012,FEMALE,0,0,0,468,468,485.0
PERL,2012,FEMALE,0,0,0,432,432,521.0
PERLA,2012,FEMALE,0,0,792,0,792,326.0
PERRY,2012,FEMALE,0,0,0,612,612,388.0
PESSY,2012,FEMALE,0,0,0,972,972,296.0
PEYTON,2012,FEMALE,0,3888,1728,1188,6804,102.0
PHOEBE,2012,FEMALE,1584,0,0,1440,3024,174.0
PHOENIX,2012,FEMALE,0,396,0,0,396,550.0
PIPER,2012,FEMALE,0,0,0,648,648,375.0
POLINA,2012,FEMALE,0,0,0,432,432,521.0
PRINCESS,2012,FEMALE,0,396,0,0,396,550.0
QUEENIE,2012,FEMALE,720,0,0,0,720,344.0
QUINN,2012,FEMALE,0,0,0,720,720,344.0
RACHEL,2012,FEMALE,2592,0,2376,20088,25056,25.0
RAIZEL,2012,FEMALE,0,0,0,612,612,388.0
RAIZY,2012,FEMALE,0,0,0,1872,1872,218.0
RAQUEL,2012,FEMALE,0,0,0,432,432,521.0
REAGAN,2012,FEMALE,0,0,0,792,792,326.0
REBECCA,2012,FEMALE,1512,0,1944,4860,8316,85.0
REEM,2012,FEMALE,0,0,0,360,360,588.0
REESE,2012,FEMALE,0,0,0,900,900,302.0
RIFKY,2012,FEMALE,0,0,0,504,504,457.0
RIHANNA,2012,FEMALE,0,0,468,0,468,485.0
RILEY,2012,FEMALE,1080,2484,0,4320,7884,89.0
RIVKA,2012,FEMALE,0,0,0,3456,3456,160.0
RIVKY,2012,FEMALE,0,0,0,1800,1800,225.0
ROCHEL,2012,FEMALE,0,0,0,720,720,344.0
ROIZY,2012,FEMALE,0,0,0,396,396,550.0
ROSA,2012,FEMALE,0,0,858,825,1683,235.0
ROSE,2012,FEMALE,0,0,0,1296,1296,262.0
ROSELYN,2012,FEMALE,0,0,540,0,540,427.0
ROSIE,2012,FEMALE,0,0,0,360,360,588.0
RUBY,2012,FEMALE,0,0,1224,2736,3960,148.0
RUCHY,2012,FEMALE,0,0,0,792,792,326.0
RUTH,2012,FEMALE,0,0,858,935,1793,229.0
RYAN,2012,FEMALE,0,0,0,468,468,485.0
SABRINA,2012,FEMALE,2376,0,1296,3132,6804,102.0
SADIE,2012,FEMALE,0,0,0,1296,1296,262.0
SAGE,2012,FEMALE,0,0,0,360,360,588.0
SALMA,2012,FEMALE,0,0,0,540,540,427.0
SALOME,2012,FEMALE,0,0,360,0,360,588.0
SAMANTHA,2012,FEMALE,4896,2592,15696,10656,33840,16.0
SAMARA,2012,FEMALE,0,540,0,0,540,427.0
SAMIYAH,2012,FEMALE,0,432,0,0,432,521.0
SANAA,2012,FEMALE,0,792,0,0,792,326.0
SANAI,2012,FEMALE,0,684,0,0,684,360.0
SANDRA,2012,FEMALE,0,0,360,0,360,588.0
SANIYAH,2012,FEMALE,0,576,0,0,576,408.0
SARA,2012,FEMALE,2592,0,2268,14364,19224,34.0
SARAH,2012,FEMALE,6768,4176,6192,30096,47232,10.0
SARAI,2012,FEMALE,0,1152,1368,0,2520,192.0
SARIAH,2012,FEMALE,0,540,0,0,540,427.0
SASHA,2012,FEMALE,0,936,0,936,1872,218.0
SAVANNA,2012,FEMALE,0,0,275,0,275,639.0
SAVANNAH,2012,FEMALE,1584,5328,5904,3168,15984,41.0
SCARLET,2012,FEMALE,0,0,720,0,720,344.0
SCARLETT,2012,FEMALE,0,0,4608,3096,7704,91.0
SELENA,2012,FEMALE,1584,0,1080,0,2664,187.0
SELINA,2012,FEMALE,1476,0,0,0,1476,253.0
SELMA,2012,FEMALE,0,0,0,360,360,588.0
SERENA,2012,FEMALE,792,0,0,0,792,326.0
SERENITY,2012,FEMALE,0,4248,3888,0,8136,87.0
SHAINA,2012,FEMALE,0,0,0,504,504,457.0
SHAINDY,2012,FEMALE,0,0,0,2556,2556,190.0
SHARON,2012,FEMALE,504,0,0,0,504,457.0
SHAYLA,2012,FEMALE,0,360,0,0,360,588.0
SHERLYN,2012,FEMALE,0,0,1152,0,1152,272.0
SHERRY,2012,FEMALE,468,0,0,0,468,485.0
SHIFRA,2012,FEMALE,0,0,0,684,684,360.0
SHIRA,2012,FEMALE,0,0,0,576,576,408.0
SHIRLEY,2012,FEMALE,720,0,0,0,720,344.0
SHOSHANA,2012,FEMALE,0,0,0,540,540,427.0
SIENA,2012,FEMALE,0,0,0,612,612,388.0
SIENNA,2012,FEMALE,0,0,1152,2808,3960,148.0
SIMA,2012,FEMALE,0,0,0,540,540,427.0
SIMONE,2012,FEMALE,0,0,0,720,720,344.0
SKYE,2012,FEMALE,0,468,0,0,468,485.0
SKYLA,2012,FEMALE,0,2088,1152,0,3240,168.0
SKYLAH,2012,FEMALE,0,504,0,0,504,457.0
SKYLAR,2012,FEMALE,0,4644,1728,3024,9396,78.0
SLOANE,2012,FEMALE,0,0,0,475,475,484.0
SOFIA,2012,FEMALE,2592,0,17820,10800,31212,17.0
SONIA,2012,FEMALE,0,0,0,360,360,588.0
SOPHIA,2012,FEMALE,19008,3036,25960,21780,69784,1.0
SOPHIE,2012,FEMALE,4320,0,1728,9720,15768,43.0
STACEY,2012,FEMALE,0,0,396,0,396,550.0
STACY,2012,FEMALE,0,0,468,0,468,485.0
STELLA,2012,FEMALE,3366,0,1020,6290,10676,71.0
STEPHANIE,2012,FEMALE,1938,1020,4080,0,7038,99.0
SUMMER,2012,FEMALE,1080,2916,1404,0,5400,117.0
SURY,2012,FEMALE,0,0,0,1116,1116,280.0
SYDNEY,2012,FEMALE,1404,1836,0,4104,7344,94.0
SYEDA,2012,FEMALE,360,0,0,0,360,588.0
SYLVIA,2012,FEMALE,0,0,0,576,576,408.0
SYLVIE,2012,FEMALE,0,0,0,360,360,588.0
TALIA,2012,FEMALE,0,792,0,2520,3312,165.0
TAMAR,2012,FEMALE,0,0,0,432,432,521.0
TAMIA,2012,FEMALE,0,720,0,0,720,344.0
TASNIM,2012,FEMALE,360,0,0,0,360,588.0
TATIANA,2012,FEMALE,0,0,504,0,504,457.0
TAYLOR,2012,FEMALE,0,5112,0,1872,6984,100.0
TENZIN,2012,FEMALE,1116,0,0,0,1116,280.0
TESSA,2012,FEMALE,0,0,0,396,396,550.0
TIANA,2012,FEMALE,0,612,0,0,612,388.0
TIFFANY,2012,FEMALE,3024,0,1584,0,4608,130.0
TINA,2012,FEMALE,540,0,0,0,540,427.0
TOBY,2012,FEMALE,0,0,0,1872,1872,218.0
TORI,2012,FEMALE,0,468,0,0,468,485.0
TRINITY,2012,FEMALE,0,684,0,0,684,360.0
TZIPORA,2012,FEMALE,0,0,0,468,468,485.0
TZIVIA,2012,FEMALE,0,0,0,396,396,550.0
VALENTINA,2012,FEMALE,0,0,4896,2592,7488,93.0
VALERIA,2012,FEMALE,0,0,1332,0,1332,258.0
VALERIE,2012,FEMALE,0,0,3816,1224,5040,123.0
VANESSA,2012,FEMALE,2070,1955,6072,2898,12995,52.0
VERA,2012,FEMALE,0,0,0,648,648,375.0
VERONICA,2012,FEMALE,0,0,1080,1944,3024,174.0
VICKY,2012,FEMALE,900,0,0,0,900,302.0
VICTORIA,2012,FEMALE,3450,4485,12558,15042,35535,15.0
VIOLET,2012,FEMALE,1380,1518,2346,5405,10649,72.0
VIRGINIA,2012,FEMALE,0,0,0,432,432,521.0
VIVIAN,2012,FEMALE,2880,0,0,1656,4536,133.0
VIVIANA,2012,FEMALE,0,0,300,0,300,637.0
VIVIENNE,2012,FEMALE,0,0,0,1332,1332,258.0
WENDY,2012,FEMALE,0,0,396,0,396,550.0
WILLA,2012,FEMALE,0,0,0,612,612,388.0
WINNIE,2012,FEMALE,1044,0,0,0,1044,287.0
WYNTER,2012,FEMALE,0,360,0,0,360,588.0
XIMENA,2012,FEMALE,0,0,540,0,540,427.0
XIN,2012,FEMALE,612,0,0,0,612,388.0
YAEL,2012,FEMALE,0,0,0,575,575,425.0
YAMILETH,2012,FEMALE,0,0,432,0,432,521.0
YARA,2012,FEMALE,0,0,0,360,360,588.0
YARETZI,2012,FEMALE,0,0,1728,0,1728,232.0
YEHUDIS,2012,FEMALE,0,0,0,612,612,388.0
YESENIA,2012,FEMALE,0,0,396,0,396,550.0
YIDES,2012,FEMALE,0,0,0,1044,1044,287.0
YITTA,2012,FEMALE,0,0,0,432,432,521.0
YITTY,2012,FEMALE,0,0,0,1548,1548,248.0
YOCHEVED,2012,FEMALE,0,0,0,1152,1152,272.0
ZAHRA,2012,FEMALE,504,0,0,0,504,457.0
ZAINAB,2012,FEMALE,648,0,0,0,648,375.0
ZARA,2012,FEMALE,612,0,0,0,612,388.0
ZISSY,2012,FEMALE,0,0,0,1152,1152,272.0
ZOE,2012,FEMALE,3680,4968,9246,12834,30728,19.0
ZOEY,2012,FEMALE,2760,2530,4278,3450,13018,51.0
ZURI,2012,FEMALE,0,360,0,0,360,588.0
AARAV,2012,MALE,360,0,0,0,360,525.0
AARON,2012,MALE,6930,6195,13230,11970,38325,34.0
AAYAN,2012,MALE,468,0,0,0,468,438.0
ABDIEL,2012,MALE,0,0,396,0,396,498.0
ABDOUL,2012,MALE,0,360,0,0,360,525.0
ABDOULAYE,2012,MALE,0,540,0,0,540,392.0
ABDUL,2012,MALE,1152,1080,0,0,2232,206.0
ABDULLAH,2012,MALE,1008,0,0,0,1008,286.0
ABEL,2012,MALE,0,0,864,0,864,311.0
ABRAHAM,2012,MALE,0,0,1368,9504,10872,90.0
ADAM,2012,MALE,5904,2880,6912,20160,35856,39.0
ADAN,2012,MALE,0,0,396,0,396,498.0
ADEN,2012,MALE,0,0,396,0,396,498.0
ADITYA,2012,MALE,396,0,0,0,396,498.0
ADONIS,2012,MALE,0,1080,1152,0,2232,206.0
ADRIAN,2012,MALE,3564,2640,18040,5412,29656,44.0
ADRIEL,2012,MALE,0,0,864,0,864,311.0
AHMAD,2012,MALE,0,0,0,540,540,392.0
AHMED,2012,MALE,1080,0,0,2448,3528,160.0
AHRON,2012,MALE,0,0,0,396,396,498.0
AIDAN,2012,MALE,4290,1848,3300,3960,13398,79.0
AIDEN,2012,MALE,15576,17160,25850,9636,68222,11.0
AKIVA,2012,MALE,0,0,0,720,720,341.0
ALAN,2012,MALE,3570,0,3910,2754,10234,91.0
ALBERT,2012,MALE,1944,0,2808,2268,7020,113.0
ALBERTO,2012,MALE,0,0,504,0,504,419.0
ALDO,2012,MALE,0,0,504,0,504,419.0
ALEJANDRO,2012,MALE,0,0,2268,0,2268,204.0
ALEKSANDER,2012,MALE,0,0,0,360,360,525.0
ALEX,2012,MALE,7776,1728,7632,3312,20448,58.0
ALEXANDER,2012,MALE,10074,5796,23000,31326,70196,10.0
ALEXIS,2012,MALE,0,0,1728,0,1728,232.0
ALI,2012,MALE,1734,1428,0,3655,6817,116.0
ALLEN,2012,MALE,2520,0,1584,0,4104,154.0
ALPHA,2012,MALE,0,504,0,0,504,419.0
ALSTON,2012,MALE,504,0,0,0,504,419.0
ALTER,2012,MALE,0,0,0,540,540,392.0
ALVIN,2012,MALE,3240,0,864,0,4104,154.0
AMADOU,2012,MALE,0,756,0,0,756,333.0
AMAR'E,2012,MALE,0,576,0,0,576,380.0
AMARE,2012,MALE,0,540,0,0,540,392.0
AMARI,2012,MALE,0,1584,0,0,1584,241.0
AMIR,2012,MALE,0,7128,1620,2700,11448,89.0
ANDERSON,2012,MALE,0,0,2664,792,3456,163.0
ANDRE,2012,MALE,0,1008,1296,0,2304,200.0
ANDRES,2012,MALE,0,0,1152,0,1152,265.0
ANDREW,2012,MALE,7260,5500,14784,15972,43516,30.0
ANDY,2012,MALE,4176,0,3672,0,7848,109.0
ANGEL,2012,MALE,0,0,5900,0,5900,130.0
ANGELO,2012,MALE,0,0,1008,1368,2376,198.0
ANGUS,2012,MALE,576,0,0,0,576,380.0
ANSON,2012,MALE,900,0,0,0,900,304.0
ANTHONY,2012,MALE,6480,8352,27936,19152,61920,14.0
ANTONIO,2012,MALE,0,1056,2560,2000,5616,133.0
ARCHER,2012,MALE,0,0,0,396,396,498.0
ARI,2012,MALE,0,0,0,1440,1440,250.0
ARIEL,2012,MALE,0,0,1296,1440,2736,182.0
ARJUN,2012,MALE,756,0,0,0,756,333.0
ARMANDO,2012,MALE,0,0,360,0,360,525.0
ARMANI,2012,MALE,0,720,1224,0,1944,214.0
ARON,2012,MALE,0,0,0,2520,2520,191.0
ARTHUR,2012,MALE,0,0,0,1044,1044,276.0
ARYAN,2012,MALE,504,0,0,0,504,419.0
ARYEH,2012,MALE,0,0,0,972,972,295.0
ASHER,2012,MALE,864,0,0,4248,5112,138.0
ASHTON,2012,MALE,0,1152,720,0,1872,220.0
ATTICUS,2012,MALE,0,0,0,360,360,525.0
AUGUST,2012,MALE,0,0,0,1116,1116,269.0
AUSTIN,2012,MALE,9648,3888,2304,2736,18576,66.0
AVERY,2012,MALE,0,2160,1296,1296,4752,142.0
AVRAHAM,2012,MALE,0,0,0,1620,1620,238.0
AVROHOM,2012,MALE,0,0,0,1044,1044,276.0
AVRUM,2012,MALE,0,0,0,648,648,358.0
AXEL,2012,MALE,0,0,1872,0,1872,220.0
AYAAN,2012,MALE,1476,0,0,0,1476,249.0
AYAN,2012,MALE,432,0,0,0,432,467.0
AYDEN,2012,MALE,2736,10080,9648,2736,25200,52.0
BARUCH,2012,MALE,0,0,0,450,450,464.0
BECKETT,2012,MALE,0,0,0,396,396,498.0
BEN,2012,MALE,0,0,0,648,648,358.0
BENJAMIN,2012,MALE,5290,3312,8556,30084,47242,25.0
BENNETT,2012,MALE,0,0,0,360,360,525.0
BENSON,2012,MALE,540,0,0,0,540,392.0
BENTZION,2012,MALE,0,0,0,432,432,467.0
BENZION,2012,MALE,0,0,0,468,468,438.0
BINYOMIN,2012,MALE,0,0,0,275,275,578.0
BLAKE,2012,MALE,0,2592,1296,2592,6480,120.0
BORUCH,2012,MALE,0,0,0,396,396,498.0
BOUBACAR,2012,MALE,0,360,0,0,360,525.0
BRADLEY,2012,MALE,0,1080,1728,1296,4104,154.0
BRADY,2012,MALE,0,0,0,792,792,324.0
BRANDON,2012,MALE,5472,7200,22032,6480,41184,32.0
BRAYAN,2012,MALE,0,0,828,0,828,318.0
BRAYDEN,2012,MALE,1620,0,1620,2376,5616,133.0
BRENDAN,2012,MALE,0,0,0,864,864,311.0
BRIAN,2012,MALE,5904,1728,5472,2880,15984,70.0
BRODY,2012,MALE,0,0,0,540,540,392.0
BRUCE,2012,MALE,720,0,936,0,1656,234.0
BRYAN,2012,MALE,1944,1836,10044,0,13824,77.0
BRYANT,2012,MALE,0,0,468,0,468,438.0
BRYCE,2012,MALE,0,1760,726,0,2486,194.0
BRYSON,2012,MALE,0,360,0,0,360,525.0
CADEN,2012,MALE,0,360,0,0,360,525.0
CALEB,2012,MALE,2160,5904,6192,5040,19296,63.0
CALVIN,2012,MALE,720,0,0,792,1512,246.0
CAMERON,2012,MALE,0,5832,1944,2268,10044,92.0
CAMILO,2012,MALE,0,0,432,0,432,467.0
CAMREN,2012,MALE,0,396,0,0,396,498.0
CARLOS,2012,MALE,0,0,3708,0,3708,159.0
CARMELO,2012,MALE,0,792,720,0,1512,246.0
CARSON,2012,MALE,360,0,0,0,360,525.0
CARTER,2012,MALE,1440,7200,2016,2736,13392,80.0
CAYDEN,2012,MALE,0,684,0,0,684,349.0
CESAR,2012,MALE,0,0,1224,0,1224,262.0
CHAD,2012,MALE,0,396,0,0,396,498.0
CHAIM,2012,MALE,0,0,0,6084,6084,125.0
CHANCE,2012,MALE,0,900,0,0,900,304.0
CHARLES,2012,MALE,2530,2484,1656,19182,25852,51.0
CHARLIE,2012,MALE,0,0,936,2088,3024,172.0
CHASE,2012,MALE,1872,8064,3024,4752,17712,67.0
CHESKEL,2012,MALE,0,0,0,360,360,525.0
CHESKY,2012,MALE,0,0,0,576,576,380.0
CHRIS,2012,MALE,0,0,2304,1008,3312,168.0
CHRISTIAN,2012,MALE,3174,14352,19182,8395,45103,28.0
CHRISTOPHER,2012,MALE,2160,9792,28080,10656,50688,19.0
CODY,2012,MALE,360,0,0,0,360,525.0
COLE,2012,MALE,0,0,0,720,720,341.0
COLIN,2012,MALE,0,0,0,1620,1620,238.0
CONNOR,2012,MALE,1836,1080,0,4752,7668,110.0
COOPER,2012,MALE,0,0,0,1260,1260,260.0
CRISTIAN,2012,MALE,0,0,1368,0,1368,254.0
CRISTOPHER,2012,MALE,0,0,540,0,540,392.0
CYRUS,2012,MALE,396,0,0,0,396,498.0
DAMANI,2012,MALE,0,360,0,0,360,525.0
DAMIAN,2012,MALE,0,0,3168,1080,4248,149.0
DAMIEN,2012,MALE,0,0,396,0,396,498.0
DANIEL,2012,MALE,13524,9246,26220,32016,81006,5.0
DANNY,2012,MALE,936,0,1512,0,2448,195.0
DANTE,2012,MALE,0,0,576,0,576,380.0
DARIEL,2012,MALE,0,0,1044,0,1044,276.0
DARIUS,2012,MALE,0,504,0,0,504,419.0
DARREN,2012,MALE,1430,858,0,0,2288,203.0
DARWIN,2012,MALE,0,0,756,0,756,333.0
DAVID,2012,MALE,5760,9648,25344,41616,82368,4.0
DEAN,2012,MALE,0,0,720,1800,2520,191.0
DECLAN,2012,MALE,0,0,0,1368,1368,254.0
DENZEL,2012,MALE,0,0,504,0,504,419.0
DEREK,2012,MALE,2520,0,3600,0,6120,124.0
DERRICK,2012,MALE,0,396,0,0,396,498.0
DEVIN,2012,MALE,2304,2592,3168,1440,9504,96.0
DIEGO,2012,MALE,0,0,2160,0,2160,210.0
DOMINIC,2012,MALE,0,1836,2380,2856,7072,112.0
DOMINICK,2012,MALE,0,0,792,1440,2232,206.0
DONOVAN,2012,MALE,0,0,432,0,432,467.0
DOV,2012,MALE,0,0,0,1152,1152,265.0
DOVID,2012,MALE,0,0,0,936,936,298.0
DREW,2012,MALE,0,0,0,540,540,392.0
DYLAN,2012,MALE,10626,8004,25392,14260,58282,16.0
EASON,2012,MALE,1080,0,0,0,1080,272.0
EDDY,2012,MALE,0,0,432,0,432,467.0
EDGAR,2012,MALE,0,0,1008,0,1008,286.0
EDISON,2012,MALE,576,0,0,0,576,380.0
EDUARDO,2012,MALE,0,0,1440,0,1440,250.0
EDWARD,2012,MALE,1020,0,3910,3570,8500,102.0
EDWIN,2012,MALE,0,0,1908,0,1908,217.0
EFRAIM,2012,MALE,0,0,0,684,684,349.0
EITAN,2012,MALE,0,0,0,756,756,333.0
ELAN,2012,MALE,0,0,0,432,432,467.0
ELI,2012,MALE,1728,4896,6912,14256,27792,46.0
ELIAN,2012,MALE,0,0,792,0,792,324.0
ELIAS,2012,MALE,0,1080,7992,3672,12744,85.0
ELIEZER,2012,MALE,0,0,0,1044,1044,276.0
ELIJAH,2012,MALE,2736,16560,14112,4176,37584,36.0
ELIMELECH,2012,MALE,0,0,0,648,648,358.0
ELIYAHU,2012,MALE,0,0,0,1044,1044,276.0
ELLIOT,2012,MALE,0,0,0,1044,1044,276.0
ELLIOTT,2012,MALE,0,0,0,360,360,525.0
ELLIS,2012,MALE,0,0,0,396,396,498.0
ELUZER,2012,MALE,0,0,0,396,396,498.0
ELVIN,2012,MALE,0,0,360,0,360,525.0
ELVIS,2012,MALE,360,0,0,0,360,525.0
EMANUEL,2012,MALE,0,0,1116,0,1116,269.0
EMILIANO,2012,MALE,0,0,360,0,360,525.0
EMILIO,2012,MALE,0,0,900,0,900,304.0
EMMANUEL,2012,MALE,0,2376,5976,0,8352,103.0
EMMETT,2012,MALE,0,0,0,468,468,438.0
ENRIQUE,2012,MALE,0,0,396,0,396,498.0
EPHRAIM,2012,MALE,0,0,0,540,540,392.0
ERIC,2012,MALE,17712,3168,4896,5040,30816,42.0
ERICK,2012,MALE,0,0,2736,0,2736,182.0
ERIK,2012,MALE,0,0,1584,720,2304,200.0
ESTEBAN,2012,MALE,0,0,612,0,612,370.0
ETHAN,2012,MALE,26928,21744,36576,18864,104112,1.0
EVAN,2012,MALE,11952,3024,8496,9792,33264,41.0
EVERETT,2012,MALE,0,0,0,540,540,392.0
EZEKIEL,2012,MALE,0,0,360,0,360,525.0
EZEQUIEL,2012,MALE,0,0,648,0,648,358.0
EZRA,2012,MALE,0,0,0,1908,1908,217.0
EZRIEL,2012,MALE,0,0,0,360,360,525.0
FABIAN,2012,MALE,0,0,612,0,612,370.0
FELIX,2012,MALE,2244,0,1530,2142,5916,129.0
FERNANDO,2012,MALE,0,0,1044,0,1044,276.0
FILIP,2012,MALE,0,0,0,540,540,392.0
FINN,2012,MALE,0,0,0,936,936,298.0
FRANCESCO,2012,MALE,0,0,0,432,432,467.0
FRANCISCO,2012,MALE,0,0,720,0,720,341.0
FRANK,2012,MALE,0,0,936,2376,3312,168.0
FRANKLIN,2012,MALE,0,0,468,0,468,438.0
FREDDY,2012,MALE,0,0,432,0,432,467.0
FREDERICK,2012,MALE,0,0,0,360,360,525.0
GABRIEL,2012,MALE,3888,5328,19008,15264,43488,31.0
GAEL,2012,MALE,0,0,2448,0,2448,195.0
GAVIN,2012,MALE,3450,2622,3312,5520,14904,73.0
GAVRIEL,2012,MALE,0,0,0,720,720,341.0
GEORGE,2012,MALE,0,0,1368,5400,6768,117.0
GIOVANNI,2012,MALE,0,1296,4320,2268,7884,108.0
GORDON,2012,MALE,432,0,0,0,432,467.0
GRAHAM,2012,MALE,0,0,0,756,756,333.0
GRANT,2012,MALE,0,0,0,540,540,392.0
GRAYSON,2012,MALE,0,0,0,864,864,311.0
GREGORY,2012,MALE,0,0,924,715,1639,236.0
GRIFFIN,2012,MALE,0,0,0,684,684,349.0
GUSTAVO,2012,MALE,0,0,540,0,540,392.0
HAMZA,2012,MALE,792,0,0,1008,1800,224.0
HAO,2012,MALE,396,0,0,0,396,498.0
HARRISON,2012,MALE,936,0,0,2160,3096,171.0
HARRY,2012,MALE,0,0,0,325,325,574.0
HARVEY,2012,MALE,0,0,0,360,360,525.0
HAYDEN,2012,MALE,792,0,0,720,1512,246.0
HECTOR,2012,MALE,0,0,1008,0,1008,286.0
HENRY,2012,MALE,3366,0,3672,13770,20808,56.0
HERSH,2012,MALE,0,0,0,504,504,419.0
HERSHEL,2012,MALE,0,0,0,525,525,418.0
HERSHY,2012,MALE,0,0,0,900,900,304.0
HUDSON,2012,MALE,864,0,0,4320,5184,137.0
HUGO,2012,MALE,0,0,770,990,1760,231.0
HUNTER,2012,MALE,2448,3024,1728,4464,11664,88.0
IAN,2012,MALE,6192,3456,11952,4464,26064,49.0
IBRAHIM,2012,MALE,3132,3024,0,1944,8100,105.0
IBRAHIMA,2012,MALE,0,612,0,0,612,370.0
IKER,2012,MALE,0,0,1044,0,1044,276.0
ILAN,2012,MALE,0,0,0,612,612,370.0
ISAAC,2012,MALE,3600,2448,13536,16704,36288,38.0
ISAIAH,2012,MALE,0,10260,8532,1080,19872,60.0
ISMAEL,2012,MALE,0,0,1044,0,1044,276.0
ISRAEL,2012,MALE,0,1188,2160,3240,6588,119.0
ISSAC,2012,MALE,0,0,0,360,360,525.0
IVAN,2012,MALE,7344,0,4536,1728,13608,78.0
IZAIAH,2012,MALE,0,0,396,0,396,498.0
JACE,2012,MALE,0,2160,3780,1080,7020,113.0
JACK,2012,MALE,2210,0,2856,18360,23426,54.0
JACKSON,2012,MALE,1836,0,1836,9180,12852,83.0
JACKY,2012,MALE,504,0,0,0,504,419.0
JACOB,2012,MALE,6912,8352,42192,34848,92304,2.0
JAD,2012,MALE,0,0,0,360,360,525.0
JADEN,2012,MALE,4536,5400,3132,0,13068,82.0
JADIEL,2012,MALE,0,0,1764,0,1764,228.0
JAEL,2012,MALE,0,0,792,0,792,324.0
JAHMIR,2012,MALE,0,432,0,0,432,467.0
JAIDEN,2012,MALE,0,2088,1440,0,3528,160.0
JAIME,2012,MALE,0,0,425,0,425,497.0
JAKE,2012,MALE,2052,0,4104,6264,12420,87.0
JALEN,2012,MALE,0,612,0,0,612,370.0
JAMARI,2012,MALE,0,576,0,0,576,380.0
JAMES,2012,MALE,6192,4896,10512,26928,48528,21.0
JARED,2012,MALE,0,0,684,0,684,349.0
JARIEL,2012,MALE,0,0,792,0,792,324.0
JASIAH,2012,MALE,0,576,0,0,576,380.0
JASON,2012,MALE,14544,7920,13104,5184,40752,33.0
JASPER,2012,MALE,1008,0,0,1944,2952,175.0
JAVIER,2012,MALE,0,0,1116,0,1116,269.0
JAXON,2012,MALE,0,0,0,432,432,467.0
JAY,2012,MALE,1296,0,1080,0,2376,198.0
JAYCE,2012,MALE,0,0,756,0,756,333.0
JAYDEN,2012,MALE,19635,17955,38220,3780,79590,8.0
JAYLEN,2012,MALE,0,2088,720,0,2808,180.0
JAYREN,2012,MALE,0,0,360,0,360,525.0
JAYSON,2012,MALE,0,0,1008,0,1008,286.0
JEAN,2012,MALE,0,0,1188,0,1188,263.0
JEFFERSON,2012,MALE,0,0,468,0,468,438.0
JEFFREY,2012,MALE,2088,0,2304,0,4392,147.0
JENCARLOS,2012,MALE,0,0,360,0,360,525.0
JEREMIAH,2012,MALE,0,7755,7788,0,15543,71.0
JEREMY,2012,MALE,8640,2304,16848,2592,30384,43.0
JERMAINE,2012,MALE,0,504,0,0,504,419.0
JERRY,2012,MALE,1152,0,0,0,1152,265.0
JESSE,2012,MALE,0,0,0,684,684,349.0
JESUS,2012,MALE,0,0,2844,0,2844,179.0
JIMMY,2012,MALE,360,0,0,0,360,525.0
JOAQUIN,2012,MALE,0,0,540,0,540,392.0
JOEL,2012,MALE,0,2808,7020,3024,12852,83.0
JOHAN,2012,MALE,0,0,1296,0,1296,257.0
JOHN,2012,MALE,2990,2346,10212,22632,38180,35.0
JOHNNY,2012,MALE,924,0,1320,0,2244,205.0
JONAH,2012,MALE,0,1404,1836,6480,9720,94.0
JONAS,2012,MALE,0,0,360,0,360,525.0
JONATHAN,2012,MALE,7488,7200,22896,10512,48096,22.0
JORDAN,2012,MALE,2304,8640,8208,3600,22752,55.0
JORGE,2012,MALE,0,0,1332,0,1332,256.0
JOSE,2012,MALE,0,0,5004,0,5004,140.0
JOSEPH,2012,MALE,4176,7488,21600,43200,76464,9.0
JOSHUA,2012,MALE,6210,14260,24426,10902,55798,18.0
JOSIAH,2012,MALE,0,6798,3135,0,9933,93.0
JOSUE,2012,MALE,0,0,1656,0,1656,234.0
JUAN,2012,MALE,0,0,3456,0,3456,163.0
JUDAH,2012,MALE,0,1152,0,1512,2664,185.0
JUDE,2012,MALE,0,0,0,792,792,324.0
JULIAN,2012,MALE,2898,3588,14904,8050,29440,45.0
JULIEN,2012,MALE,0,0,1080,720,1800,224.0
JULIO,2012,MALE,0,0,972,0,972,295.0
JULIUS,2012,MALE,0,0,936,0,936,298.0
JUN,2012,MALE,360,0,0,0,360,525.0
JUSTICE,2012,MALE,0,540,0,0,540,392.0
JUSTIN,2012,MALE,14375,10212,29670,6624,60881,15.0
KADEN,2012,MALE,0,576,0,0,576,380.0
KAI,2012,MALE,1428,1190,0,1836,4454,146.0
KAIDEN,2012,MALE,0,2304,720,0,3024,172.0
KALEB,2012,MALE,0,1296,1008,0,2304,200.0
KAMARI,2012,MALE,0,360,0,0,360,525.0
KAREEM,2012,MALE,0,504,0,0,504,419.0
KAYDEN,2012,MALE,0,3600,2880,0,6480,120.0
KEITH,2012,MALE,0,360,0,0,360,525.0
KELVIN,2012,MALE,0,0,864,0,864,311.0
KENNETH,2012,MALE,1122,1105,3570,0,5797,131.0
KENNY,2012,MALE,0,0,540,0,540,392.0
KEVIN,2012,MALE,13824,4464,25920,5472,49680,20.0
KHALIL,2012,MALE,0,648,0,0,648,358.0
KIERAN,2012,MALE,0,0,0,540,540,392.0
KING,2012,MALE,0,1620,0,0,1620,238.0
KINGSLEY,2012,MALE,1008,0,0,0,1008,286.0
KINGSTON,2012,MALE,468,0,0,0,468,438.0
KIYAN,2012,MALE,0,540,0,0,540,392.0
KRISH,2012,MALE,540,0,0,0,540,392.0
KRISTIAN,2012,MALE,0,360,0,0,360,525.0
KYLE,2012,MALE,9360,6336,2736,2160,20592,57.0
KYMANI,2012,MALE,0,720,0,0,720,341.0
LANDON,2012,MALE,0,0,1296,1224,2520,191.0
LAWRENCE,2012,MALE,468,0,0,0,468,438.0
LAZER,2012,MALE,0,0,0,504,504,419.0
LEANDRO,2012,MALE,0,0,540,0,540,392.0
LENNY,2012,MALE,0,0,720,0,720,341.0
LEO,2012,MALE,4644,0,1728,11124,17496,68.0
LEON,2012,MALE,1512,1188,0,3240,5940,127.0
LEONARDO,2012,MALE,0,0,4032,2376,6408,123.0
LEONEL,2012,MALE,0,0,360,0,360,525.0
LEVI,2012,MALE,0,1080,0,4176,5256,136.0
LIAM,2012,MALE,5940,10032,15400,14520,45892,27.0
LIPA,2012,MALE,0,0,0,936,936,298.0
LOGAN,2012,MALE,3450,5658,8970,7820,25898,50.0
LORENZO,2012,MALE,0,0,1080,1512,2592,187.0
LOUIS,2012,MALE,1836,0,1512,2592,5940,127.0
LUCA,2012,MALE,0,0,936,5112,6048,126.0
LUCAS,2012,MALE,18576,2160,17280,17856,55872,17.0
LUIS,2012,MALE,0,0,4608,0,4608,143.0
LUKA,2012,MALE,0,0,0,828,828,318.0
LUKAS,2012,MALE,0,0,792,1800,2592,187.0
LUKE,2012,MALE,3450,2484,1380,11615,18929,65.0
MAHAMADOU,2012,MALE,0,360,0,0,360,525.0
MAKAI,2012,MALE,0,360,0,0,360,525.0
MAKHI,2012,MALE,0,396,0,0,396,498.0
MAKSIM,2012,MALE,0,0,0,360,360,525.0
MALACHI,2012,MALE,0,1980,0,0,1980,213.0
MALIK,2012,MALE,0,1800,0,864,2664,185.0
MAMADOU,2012,MALE,0,1188,0,0,1188,263.0
MANUEL,2012,MALE,0,0,1584,0,1584,241.0
MARC,2012,MALE,0,0,0,325,325,574.0
MARCO,2012,MALE,0,0,2088,2160,4248,149.0
MARCOS,2012,MALE,0,0,900,0,900,304.0
MARCUS,2012,MALE,5106,4002,2898,1265,13271,81.0
MARIO,2012,MALE,0,0,648,0,648,358.0
MARK,2012,MALE,0,0,1080,3384,4464,145.0
MARLON,2012,MALE,0,0,468,0,468,438.0
MARTIN,2012,MALE,0,0,1152,2376,3528,160.0
MARVIN,2012,MALE,0,0,504,0,504,419.0
MASON,2012,MALE,8928,14832,27072,14400,65232,12.0
MATEO,2012,MALE,0,0,5544,1224,6768,117.0
MATHEW,2012,MALE,0,0,792,0,792,324.0
MATHIAS,2012,MALE,0,0,468,0,468,438.0
MATIAS,2012,MALE,0,0,720,0,720,341.0
MATTEO,2012,MALE,0,0,792,2016,2808,180.0
MATTHEW,2012,MALE,9775,8280,38502,23184,79741,7.0
MAURICE,2012,MALE,0,325,0,0,325,574.0
MAURICIO,2012,MALE,0,0,468,0,468,438.0
MAX,2012,MALE,3564,0,4212,11448,19224,64.0
MAXIM,2012,MALE,0,0,0,600,600,379.0
MAXIMILIAN,2012,MALE,0,0,0,1080,1080,272.0
MAXIMILIANO,2012,MALE,0,0,612,0,612,370.0
MAXIMUS,2012,MALE,0,0,1872,1008,2880,177.0
MAXWELL,2012,MALE,1728,0,1944,5832,9504,96.0
MAYER,2012,MALE,0,0,0,828,828,318.0
MEIR,2012,MALE,0,0,0,1800,1800,224.0
MEKHI,2012,MALE,0,756,0,0,756,333.0
MELVIN,2012,MALE,0,0,684,0,684,349.0
MENACHEM,2012,MALE,0,0,0,2736,2736,182.0
MENDEL,2012,MALE,0,0,0,1800,1800,224.0
MENDY,2012,MALE,0,0,0,864,864,311.0
MESSIAH,2012,MALE,0,1080,0,0,1080,272.0
MEYER,2012,MALE,0,0,0,360,360,525.0
MICAH,2012,MALE,0,2088,0,1656,3744,158.0
MICHAEL,2012,MALE,5328,16560,26928,35280,84096,3.0
MIGUEL,2012,MALE,0,0,3348,0,3348,166.0
MIKE,2012,MALE,0,0,432,0,432,467.0
MILES,2012,MALE,1944,2052,0,5724,9720,94.0
MILO,2012,MALE,0,0,0,720,720,341.0
MOHAMED,2012,MALE,1224,4794,0,2975,8993,98.0
MOHAMMAD,2012,MALE,3190,0,0,726,3916,157.0
MOHAMMED,2012,MALE,3888,1188,0,2052,7128,111.0
MOISES,2012,MALE,0,0,468,0,468,438.0
MOISHE,2012,MALE,0,0,0,792,792,324.0
MORDECHAI,2012,MALE,0,0,0,3276,3276,170.0
MOSES,2012,MALE,0,0,0,648,648,358.0
MOSHE,2012,MALE,0,0,0,8568,8568,101.0
MOUSSA,2012,MALE,0,432,0,0,432,467.0
MUHAMMAD,2012,MALE,12096,1836,0,1404,15336,72.0
MUSA,2012,MALE,468,0,0,0,468,438.0
MUSTAFA,2012,MALE,432,0,0,0,432,467.0
MYLES,2012,MALE,0,1080,0,936,2016,212.0
NACHMAN,2012,MALE,0,0,0,612,612,370.0
NAFTALI,2012,MALE,0,0,0,864,864,311.0
NASIR,2012,MALE,0,1152,0,0,1152,265.0
NATHAN,2012,MALE,5328,6912,10944,10944,34128,40.0
NATHANAEL,2012,MALE,0,468,0,0,468,438.0
NATHANIEL,2012,MALE,3312,7728,8832,6785,26657,47.0
NEIL,2012,MALE,360,0,0,0,360,525.0
NELSON,2012,MALE,864,0,1080,0,1944,214.0
NEYMAR,2012,MALE,0,0,504,0,504,419.0
NICHOLAS,2012,MALE,5040,5616,12816,24192,47664,24.0
NICO,2012,MALE,0,0,0,432,432,467.0
NICOLAS,2012,MALE,0,0,4392,2088,6480,120.0
NIKHIL,2012,MALE,540,0,0,0,540,392.0
NIKITA,2012,MALE,0,0,0,396,396,498.0
NIKOLAS,2012,MALE,0,0,0,360,360,525.0
NOAH,2012,MALE,7632,13680,23328,18864,63504,13.0
NOAM,2012,MALE,0,0,0,504,504,419.0
NOEL,2012,MALE,0,936,1656,0,2592,187.0
NOLAN,2012,MALE,0,0,0,648,648,358.0
NOSSON,2012,MALE,0,0,0,468,468,438.0
OLIVER,2012,MALE,2916,0,4644,12096,19656,62.0
OMAR,2012,MALE,0,1428,2550,3910,7888,107.0
OMARI,2012,MALE,0,612,0,0,612,370.0
OSCAR,2012,MALE,1734,0,3876,2295,7905,106.0
OUMAR,2012,MALE,0,612,0,0,612,370.0
OWEN,2012,MALE,3888,0,0,4968,8856,99.0
PABLO,2012,MALE,0,0,576,0,576,380.0
PARKER,2012,MALE,0,0,0,792,792,324.0
PATRICK,2012,MALE,1152,0,0,2304,3456,163.0
PAUL,2012,MALE,0,1404,1296,3024,5724,132.0
PEDRO,2012,MALE,0,0,684,0,684,349.0
PETER,2012,MALE,0,0,936,3312,4248,149.0
PEYTON,2012,MALE,0,432,0,0,432,467.0
PHILIP,2012,MALE,0,0,0,575,575,390.0
PINCHAS,2012,MALE,0,0,0,468,468,438.0
PINCHUS,2012,MALE,0,0,0,468,468,438.0
PRESTON,2012,MALE,0,1296,1512,1404,4212,152.0
PRINCE,2012,MALE,0,3528,1584,0,5112,138.0
QUINN,2012,MALE,0,0,0,432,432,467.0
RAFAEL,2012,MALE,0,0,2376,2592,4968,141.0
RANDY,2012,MALE,0,0,1584,0,1584,241.0
RAPHAEL,2012,MALE,0,0,0,450,450,464.0
RAUL,2012,MALE,0,0,540,0,540,392.0
RAYAN,2012,MALE,1440,0,0,1152,2592,187.0
RAYMOND,2012,MALE,3456,0,3024,2160,8640,100.0
RAYYAN,2012,MALE,432,0,0,0,432,467.0
REED,2012,MALE,0,0,0,396,396,498.0
REHAN,2012,MALE,396,0,0,0,396,498.0
REID,2012,MALE,0,0,0,504,504,419.0
REUVEN,2012,MALE,0,0,0,504,504,419.0
RICARDO,2012,MALE,0,0,1008,0,1008,286.0
RICHARD,2012,MALE,5184,2160,5904,4176,17424,69.0
RICKY,2012,MALE,432,0,0,0,432,467.0
RILEY,2012,MALE,0,1008,936,0,1944,214.0
ROBERT,2012,MALE,0,1955,2550,7956,12461,86.0
ROBERTO,2012,MALE,0,0,648,0,648,358.0
ROCCO,2012,MALE,0,0,0,648,648,358.0
RODRIGO,2012,MALE,0,0,432,0,432,467.0
ROHAN,2012,MALE,500,0,0,0,500,437.0
ROMAN,2012,MALE,0,0,720,1152,1872,220.0
ROMEO,2012,MALE,0,0,540,0,540,392.0
RONALD,2012,MALE,0,0,468,0,468,438.0
RONAN,2012,MALE,0,0,0,432,432,467.0
RORY,2012,MALE,0,0,0,540,540,392.0
ROWAN,2012,MALE,0,0,0,432,432,467.0
ROY,2012,MALE,540,0,0,0,540,392.0
RUBEN,2012,MALE,0,0,432,0,432,467.0
RYAN,2012,MALE,28368,10224,18144,23760,80496,6.0
SALVATORE,2012,MALE,0,0,0,900,900,304.0
SAM,2012,MALE,0,0,0,1044,1044,276.0
SAMI,2012,MALE,0,0,0,360,360,525.0
SAMIR,2012,MALE,0,864,0,720,1584,241.0
SAMUEL,2012,MALE,4968,4140,11454,27324,47886,23.0
SANTIAGO,2012,MALE,0,0,1425,0,1425,252.0
SAUL,2012,MALE,0,0,432,0,432,467.0
SEAN,2012,MALE,3312,2592,2736,5904,14544,75.0
SEBASTIAN,2012,MALE,2448,2592,28512,10656,44208,29.0
SERGIO,2012,MALE,0,0,432,0,432,467.0
SHALOM,2012,MALE,0,0,0,468,468,438.0
SHANE,2012,MALE,0,1152,0,1728,2880,177.0
SHAWN,2012,MALE,0,756,0,0,756,333.0
SHAYA,2012,MALE,0,0,0,936,936,298.0
SHAYAAN,2012,MALE,468,0,0,0,468,438.0
SHAYAN,2012,MALE,360,0,0,0,360,525.0
SHEA,2012,MALE,0,0,0,396,396,498.0
SHIA,2012,MALE,0,0,0,900,900,304.0
SHIMON,2012,MALE,0,0,0,3348,3348,166.0
SHLOIME,2012,MALE,0,0,0,300,300,577.0
SHLOIMY,2012,MALE,0,0,0,576,576,380.0
SHLOMA,2012,MALE,0,0,0,396,396,498.0
SHLOME,2012,MALE,0,0,0,684,684,349.0
SHLOMO,2012,MALE,0,0,0,1908,1908,217.0
SHMIEL,2012,MALE,0,0,0,828,828,318.0
SHMUEL,2012,MALE,0,0,0,1764,1764,228.0
SHNEUR,2012,MALE,0,0,0,360,360,525.0
SHOLOM,2012,MALE,0,0,0,432,432,467.0
SHULEM,2012,MALE,0,0,0,1296,1296,257.0
SILAS,2012,MALE,0,0,0,432,432,467.0
SIMCHA,2012,MALE,0,0,0,1260,1260,260.0
SIMON,2012,MALE,0,0,0,1375,1375,253.0
SINCERE,2012,MALE,0,360,0,0,360,525.0
SKYLER,2012,MALE,0,0,396,0,396,498.0
SOLOMON,2012,MALE,0,0,0,1296,1296,257.0
SPENCER,2012,MALE,0,0,0,648,648,358.0
STANLEY,2012,MALE,648,0,0,0,648,358.0
STEPHEN,2012,MALE,0,0,715,924,1639,236.0
STEVE,2012,MALE,0,0,468,0,468,438.0
STEVEN,2012,MALE,4032,1728,10080,4464,20304,59.0
SUBHAN,2012,MALE,360,0,0,0,360,525.0
SYED,2012,MALE,1008,0,0,0,1008,286.0
TENZIN,2012,MALE,1080,0,0,0,1080,272.0
TERRELL,2012,MALE,0,360,0,0,360,525.0
TERRENCE,2012,MALE,504,0,0,0,504,419.0
THEO,2012,MALE,0,0,0,432,432,467.0
THEODORE,2012,MALE,864,0,0,6120,6984,115.0
THOMAS,2012,MALE,3600,2016,2880,18144,26640,48.0
TIMOTHY,2012,MALE,1728,1080,0,2592,5400,135.0
TOMAS,2012,MALE,0,0,0,250,250,580.0
TRISTAN,2012,MALE,3312,7776,4608,4176,19872,60.0
TROY,2012,MALE,0,468,0,0,468,438.0
TYLER,2012,MALE,5760,12960,10512,7344,36576,37.0
TZVI,2012,MALE,0,0,0,975,975,294.0
URIEL,2012,MALE,0,0,468,0,468,438.0
USHER,2012,MALE,0,0,0,972,972,295.0
VICTOR,2012,MALE,1650,0,4200,2325,8175,104.0
VIHAAN,2012,MALE,360,0,0,0,360,525.0
VINCENT,2012,MALE,8208,0,1512,4428,14148,76.0
WESLEY,2012,MALE,1944,0,1296,1296,4536,144.0
WILLIAM,2012,MALE,12834,3036,8395,22356,46621,26.0
WILSON,2012,MALE,1080,0,792,0,1872,220.0
WINSTON,2012,MALE,432,0,0,0,432,467.0
WYATT,2012,MALE,0,0,0,550,550,391.0
XAVIER,2012,MALE,0,4182,9180,1275,14637,74.0
YAAKOV,2012,MALE,0,0,0,1764,1764,228.0
YADIEL,2012,MALE,0,0,936,0,936,298.0
YAEL,2012,MALE,0,0,540,0,540,392.0
YAHIR,2012,MALE,0,0,684,0,684,349.0
YAKOV,2012,MALE,0,0,0,2196,2196,209.0
YANDEL,2012,MALE,0,0,450,0,450,464.0
YARIEL,2012,MALE,0,0,360,0,360,525.0
YECHEZKEL,2012,MALE,0,0,0,468,468,438.0
YECHIEL,2012,MALE,0,0,0,1008,1008,286.0
YEHOSHUA,2012,MALE,0,0,0,792,792,324.0
YEHUDA,2012,MALE,0,0,0,2952,2952,175.0
YISRAEL,2012,MALE,0,0,0,275,275,578.0
YISROEL,2012,MALE,0,0,0,2988,2988,174.0
YITZCHAK,2012,MALE,0,0,0,350,350,573.0
YITZCHOK,2012,MALE,0,0,0,2448,2448,195.0
YOEL,2012,MALE,0,0,0,828,828,318.0
YONA,2012,MALE,0,0,0,360,360,525.0
YOSEF,2012,MALE,0,0,0,4176,4176,153.0
YOSSI,2012,MALE,0,0,0,396,396,498.0
YOUSEF,2012,MALE,0,0,0,468,468,438.0
YOUSSEF,2012,MALE,0,0,0,396,396,498.0
YUSUF,2012,MALE,1080,0,0,1008,2088,211.0
ZACHARY,2012,MALE,4025,3588,3174,14214,25001,53.0
ZAIN,2012,MALE,864,0,0,720,1584,241.0
ZAIRE,2012,MALE,0,828,0,0,828,318.0
ZALMEN,2012,MALE,0,0,0,432,432,467.0
ZAYAN,2012,MALE,360,0,0,0,360,525.0
ZAYDEN,2012,MALE,0,0,468,0,468,438.0
ZEV,2012,MALE,0,0,0,1728,1728,232.0
ZION,2012,MALE,0,3096,1296,0,4392,147.0
Aaliyah,2013,FEMALE,0,5256,4032,0,9288,72.0
Abby,2013,FEMALE,540,0,0,0,540,422.0
Abigail,2013,FEMALE,4692,5520,13110,13248,36570,14.0
Abrielle,2013,FEMALE,0,396,0,0,396,543.0
Abril,2013,FEMALE,0,0,360,0,360,580.0
Ada,2013,FEMALE,720,0,0,792,1512,247.0
Addison,2013,FEMALE,0,0,0,936,936,303.0
Adelaide,2013,FEMALE,0,0,0,432,432,503.0
Adele,2013,FEMALE,0,0,0,756,756,335.0
Adeline,2013,FEMALE,0,0,0,432,432,503.0
Adina,2013,FEMALE,0,0,0,612,612,394.0
Adriana,2013,FEMALE,0,0,3384,1440,4824,120.0
Adrianna,2013,FEMALE,0,1296,1728,1188,4212,133.0
Ahuva,2013,FEMALE,0,0,0,648,648,376.0
Aicha,2013,FEMALE,0,468,0,0,468,464.0
Aileen,2013,FEMALE,0,0,576,0,576,406.0
Aimee,2013,FEMALE,0,0,468,0,468,464.0
Aisha,2013,FEMALE,1944,2268,0,1188,5400,114.0
Aissata,2013,FEMALE,0,360,0,0,360,580.0
Aissatou,2013,FEMALE,0,504,0,0,504,440.0
Alana,2013,FEMALE,0,1056,935,0,1991,214.0
Alani,2013,FEMALE,0,0,432,0,432,503.0
Alanis,2013,FEMALE,0,0,396,0,396,543.0
Alanna,2013,FEMALE,0,0,432,0,432,503.0
Aleena,2013,FEMALE,936,0,0,0,936,303.0
Alejandra,2013,FEMALE,0,0,325,0,325,625.0
Aleksandra,2013,FEMALE,0,0,0,396,396,543.0
Alessandra,2013,FEMALE,0,0,792,770,1562,243.0
Alessia,2013,FEMALE,0,0,0,432,432,503.0
Alexa,2013,FEMALE,0,0,4104,3816,7920,84.0
Alexandra,2013,FEMALE,1584,1584,4320,14112,21600,25.0
Alexia,2013,FEMALE,0,0,1728,720,2448,185.0
Alexis,2013,FEMALE,0,660,0,1650,2310,193.0
Alice,2013,FEMALE,3780,0,1296,5940,11016,60.0
Alicia,2013,FEMALE,0,0,684,0,684,361.0
Alina,2013,FEMALE,3264,0,1938,1275,6477,101.0
Alisa,2013,FEMALE,0,0,0,275,275,634.0
Alison,2013,FEMALE,0,0,648,0,648,376.0
Alisson,2013,FEMALE,0,0,396,0,396,543.0
Aliyah,2013,FEMALE,0,1008,1224,0,2232,197.0
Aliza,2013,FEMALE,0,0,0,648,648,376.0
Allison,2013,FEMALE,1296,0,11016,1296,13608,53.0
Allyson,2013,FEMALE,0,0,648,0,648,376.0
Alma,2013,FEMALE,0,0,720,720,1440,257.0
Alondra,2013,FEMALE,0,0,504,0,504,440.0
Alyssa,2013,FEMALE,3726,4025,5520,2622,15893,44.0
Amalia,2013,FEMALE,0,0,0,432,432,503.0
Amanda,2013,FEMALE,1188,0,3888,1404,6480,99.0
Amani,2013,FEMALE,0,360,0,0,360,580.0
Amaya,2013,FEMALE,0,1584,2160,0,3744,145.0
Amber,2013,FEMALE,2376,1728,3348,0,7452,90.0
Amelia,2013,FEMALE,4032,2310,3465,6720,16527,41.0
Amelie,2013,FEMALE,0,0,0,540,540,422.0
Amina,2013,FEMALE,0,1188,0,825,2013,213.0
Aminata,2013,FEMALE,0,1080,0,0,1080,282.0
Amira,2013,FEMALE,0,1008,0,1224,2232,197.0
Amirah,2013,FEMALE,0,432,0,0,432,503.0
Amiyah,2013,FEMALE,0,648,0,0,648,376.0
Amy,2013,FEMALE,2052,0,8856,1512,12420,55.0
Ana,2013,FEMALE,0,0,1944,936,2880,170.0
Anabel,2013,FEMALE,0,0,396,0,396,543.0
Anabella,2013,FEMALE,0,0,504,0,504,440.0
Analia,2013,FEMALE,0,0,432,0,432,503.0
Ananya,2013,FEMALE,360,0,0,0,360,580.0
Anastasia,2013,FEMALE,0,0,0,1188,1188,273.0
Anaya,2013,FEMALE,1632,1938,935,0,4505,128.0
Andrea,2013,FEMALE,0,0,1548,0,1548,246.0
Angel,2013,FEMALE,1296,936,0,0,2232,197.0
Angela,2013,FEMALE,3080,0,1386,0,4466,129.0
Angelica,2013,FEMALE,0,0,612,0,612,394.0
Angelina,2013,FEMALE,3080,1320,7260,5676,17336,37.0
Angelique,2013,FEMALE,0,0,540,0,540,422.0
Angie,2013,FEMALE,0,0,792,0,792,328.0
Anika,2013,FEMALE,468,0,0,0,468,464.0
Anisa,2013,FEMALE,0,0,0,468,468,464.0
Aniya,2013,FEMALE,0,540,0,0,540,422.0
Aniyah,2013,FEMALE,0,1008,0,0,1008,290.0
Anna,2013,FEMALE,2520,0,0,7056,9576,70.0
Annabel,2013,FEMALE,0,0,0,375,375,577.0
Annabella,2013,FEMALE,0,0,648,0,648,376.0
Annabelle,2013,FEMALE,1080,0,1512,2916,5508,113.0
Anne,2013,FEMALE,0,0,0,275,275,634.0
Annie,2013,FEMALE,648,0,0,0,648,376.0
Annika,2013,FEMALE,360,0,0,0,360,580.0
Antonia,2013,FEMALE,0,0,0,275,275,634.0
Anya,2013,FEMALE,540,0,0,0,540,422.0
April,2013,FEMALE,0,0,432,0,432,503.0
Aria,2013,FEMALE,3600,2016,3168,5040,13824,51.0
Ariana,2013,FEMALE,3726,3174,9200,4692,20792,28.0
Arianna,2013,FEMALE,2304,6912,10944,4752,24912,23.0
Arianny,2013,FEMALE,0,0,540,0,540,422.0
Ariel,2013,FEMALE,2052,4860,2052,0,8964,73.0
Ariella,2013,FEMALE,0,0,720,2520,3240,159.0
Arielle,2013,FEMALE,0,1782,605,0,2387,189.0
Arya,2013,FEMALE,936,0,0,0,936,303.0
Ashley,2013,FEMALE,6486,2208,15180,1794,25668,22.0
Asia,2013,FEMALE,0,432,0,0,432,503.0
Athena,2013,FEMALE,1020,0,1734,935,3689,146.0
Aubree,2013,FEMALE,0,0,468,0,468,464.0
Aubrey,2013,FEMALE,0,2700,3564,1512,7776,87.0
Audrey,2013,FEMALE,3162,0,1955,3570,8687,75.0
Aurora,2013,FEMALE,0,0,792,720,1512,247.0
Autumn,2013,FEMALE,0,1512,864,0,2376,190.0
Ava,2013,FEMALE,6768,10080,9792,21600,48240,7.0
Avery,2013,FEMALE,2736,1728,3024,7920,15408,46.0
Avigail,2013,FEMALE,0,0,0,360,360,580.0
Aviva,2013,FEMALE,0,0,0,432,432,503.0
Ayesha,2013,FEMALE,720,0,0,0,720,343.0
Ayleen,2013,FEMALE,0,0,576,0,576,406.0
Aylin,2013,FEMALE,0,0,1044,0,1044,285.0
Azaria,2013,FEMALE,0,360,0,0,360,580.0
Baila,2013,FEMALE,0,0,0,1908,1908,219.0
Basya,2013,FEMALE,0,0,0,432,432,503.0
Batsheva,2013,FEMALE,0,0,0,1080,1080,282.0
Beatrice,2013,FEMALE,0,0,0,720,720,343.0
Beatrix,2013,FEMALE,0,0,0,576,576,406.0
Bella,2013,FEMALE,3312,2415,8142,4416,18285,35.0
Bianca,2013,FEMALE,0,0,792,0,792,328.0
Blima,2013,FEMALE,0,0,0,900,900,311.0
Blimy,2013,FEMALE,0,0,0,1224,1224,270.0
Bracha,2013,FEMALE,0,0,0,684,684,361.0
Breindy,2013,FEMALE,0,0,0,540,540,422.0
Brenda,2013,FEMALE,0,0,275,0,275,634.0
Bria,2013,FEMALE,0,396,0,0,396,543.0
Briana,2013,FEMALE,0,0,756,0,756,335.0
Brianna,2013,FEMALE,0,2592,10692,1188,14472,48.0
Bridget,2013,FEMALE,0,0,0,432,432,503.0
Brielle,2013,FEMALE,0,5202,935,1428,7565,89.0
Britney,2013,FEMALE,0,0,350,0,350,622.0
Brittany,2013,FEMALE,0,0,1044,0,1044,285.0
Brooke,2013,FEMALE,0,1728,0,1440,3168,160.0
Bruchy,2013,FEMALE,0,0,0,396,396,543.0
Bryanna,2013,FEMALE,0,0,375,0,375,577.0
Caitlin,2013,FEMALE,0,0,0,396,396,543.0
Camila,2013,FEMALE,0,0,5652,0,5652,111.0
Camilla,2013,FEMALE,0,0,720,720,1440,257.0
Camille,2013,FEMALE,0,936,0,864,1800,229.0
Carina,2013,FEMALE,396,0,0,0,396,543.0
Carla,2013,FEMALE,0,0,504,0,504,440.0
Carmen,2013,FEMALE,0,0,360,0,360,580.0
Caroline,2013,FEMALE,2052,0,1836,4428,8316,78.0
Cassidy,2013,FEMALE,0,0,0,360,360,580.0
Cataleya,2013,FEMALE,0,0,396,0,396,543.0
Catalina,2013,FEMALE,0,0,468,0,468,464.0
Catherine,2013,FEMALE,1955,0,1020,4998,7973,83.0
Cecilia,2013,FEMALE,864,0,0,1584,2448,185.0
Celine,2013,FEMALE,1224,0,0,720,1944,215.0
Chana,2013,FEMALE,0,0,0,3750,3750,144.0
Chany,2013,FEMALE,0,0,0,1152,1152,275.0
Charlotte,2013,FEMALE,2142,0,2958,11645,16745,38.0
Chava,2013,FEMALE,0,0,0,1296,1296,264.0
Chavy,2013,FEMALE,0,0,0,360,360,580.0
Chaya,2013,FEMALE,0,0,0,6300,6300,105.0
Chelsea,2013,FEMALE,1512,2808,3348,0,7668,88.0
Chiara,2013,FEMALE,0,0,0,360,360,580.0
Chloe,2013,FEMALE,14030,9384,7452,13110,43976,11.0
Christina,2013,FEMALE,1120,1600,0,960,3680,147.0
Christine,2013,FEMALE,375,0,0,0,375,577.0
Cindy,2013,FEMALE,684,0,0,0,684,361.0
Claire,2013,FEMALE,2376,0,0,2376,4752,122.0
Clara,2013,FEMALE,0,0,0,1080,1080,282.0
Claudia,2013,FEMALE,0,0,0,576,576,406.0
Clementine,2013,FEMALE,0,0,0,360,360,580.0
Colette,2013,FEMALE,0,0,0,400,400,541.0
Connie,2013,FEMALE,360,0,0,0,360,580.0
Cora,2013,FEMALE,0,0,0,792,792,328.0
Crystal,2013,FEMALE,1080,0,1512,0,2592,179.0
Cynthia,2013,FEMALE,450,0,0,0,450,502.0
Dahlia,2013,FEMALE,0,0,0,468,468,464.0
Daisy,2013,FEMALE,0,0,1518,550,2068,210.0
Dakota,2013,FEMALE,0,468,0,0,468,464.0
Daniela,2013,FEMALE,0,0,1872,0,1872,224.0
Daniella,2013,FEMALE,0,0,1100,2508,3608,150.0
Danielle,2013,FEMALE,0,936,0,1584,2520,183.0
Danna,2013,FEMALE,0,0,1296,0,1296,264.0
Daphne,2013,FEMALE,1008,0,0,1224,2232,197.0
Dayana,2013,FEMALE,0,0,468,0,468,464.0
Delilah,2013,FEMALE,0,0,1584,0,1584,239.0
Destiny,2013,FEMALE,0,2016,1440,0,3456,154.0
Devora,2013,FEMALE,0,0,0,756,756,335.0
Devorah,2013,FEMALE,0,0,0,1908,1908,219.0
Diana,2013,FEMALE,0,0,2046,1045,3091,166.0
Dina,2013,FEMALE,0,0,0,1296,1296,264.0
Dulce,2013,FEMALE,0,0,576,0,576,406.0
Dylan,2013,FEMALE,0,0,0,432,432,503.0
Eden,2013,FEMALE,0,1080,0,1080,2160,205.0
Edith,2013,FEMALE,0,0,0,432,432,503.0
Egypt,2013,FEMALE,0,468,0,0,468,464.0
Eileen,2013,FEMALE,1188,0,550,0,1738,232.0
Elaine,2013,FEMALE,612,0,0,0,612,394.0
Eleanor,2013,FEMALE,0,0,0,1656,1656,236.0
Elena,2013,FEMALE,1404,0,2376,3132,6912,95.0
Eliana,2013,FEMALE,0,0,3744,4104,7848,86.0
Elina,2013,FEMALE,432,0,0,0,432,503.0
Elisa,2013,FEMALE,0,0,396,0,396,543.0
Elise,2013,FEMALE,726,0,0,715,1441,255.0
Elisheva,2013,FEMALE,0,0,0,612,612,394.0
Eliza,2013,FEMALE,0,0,720,2304,3024,167.0
Elizabeth,2013,FEMALE,3168,3036,6710,10010,22924,24.0
Ella,2013,FEMALE,3348,0,1512,13716,18576,33.0
Ellie,2013,FEMALE,1296,0,0,1440,2736,174.0
Eloise,2013,FEMALE,0,0,0,1008,1008,290.0
Elsa,2013,FEMALE,0,0,0,396,396,543.0
Emaan,2013,FEMALE,360,0,0,0,360,580.0
Emani,2013,FEMALE,0,432,0,0,432,503.0
Emely,2013,FEMALE,0,0,1175,0,1175,274.0
Emerson,2013,FEMALE,0,0,0,540,540,422.0
Emilia,2013,FEMALE,0,0,936,2736,3672,148.0
Emily,2013,FEMALE,10580,4554,25392,15870,56396,5.0
Emma,2013,FEMALE,8690,3300,24024,25080,61094,3.0
Emmeline,2013,FEMALE,0,0,0,396,396,543.0
Erika,2013,FEMALE,0,0,396,0,396,543.0
Erin,2013,FEMALE,576,0,0,0,576,406.0
Esmeralda,2013,FEMALE,0,0,1008,0,1008,290.0
Ester,2013,FEMALE,0,0,0,250,250,642.0
Esther,2013,FEMALE,0,1080,2268,23112,26460,21.0
Esty,2013,FEMALE,0,0,0,1044,1044,285.0
Etty,2013,FEMALE,0,0,0,720,720,343.0
Eunice,2013,FEMALE,360,0,0,0,360,580.0
Eva,2013,FEMALE,3696,1430,5280,6270,16676,39.0
Eve,2013,FEMALE,0,0,0,720,720,343.0
Evelyn,2013,FEMALE,3888,0,5832,6048,15768,45.0
Faiga,2013,FEMALE,0,0,0,936,936,303.0
Faigy,2013,FEMALE,0,0,0,2556,2556,182.0
Faith,2013,FEMALE,0,3240,1656,0,4896,118.0
Farah,2013,FEMALE,0,0,0,396,396,543.0
Fatima,2013,FEMALE,3744,3168,1584,1440,9936,69.0
Fatoumata,2013,FEMALE,0,1584,0,0,1584,239.0
Fiona,2013,FEMALE,2664,0,0,3672,6336,104.0
Fradel,2013,FEMALE,0,0,0,468,468,464.0
Fraidy,2013,FEMALE,0,0,0,1152,1152,275.0
Frances,2013,FEMALE,0,0,0,300,300,626.0
Francesca,2013,FEMALE,0,0,0,972,972,296.0
Freya,2013,FEMALE,0,0,0,360,360,580.0
Frimet,2013,FEMALE,0,0,0,468,468,464.0
Gabriela,2013,FEMALE,0,0,3528,1224,4752,122.0
Gabriella,2013,FEMALE,0,3348,8640,7884,19872,29.0
Gabrielle,2013,FEMALE,0,2178,0,990,3168,160.0
Gemma,2013,FEMALE,0,0,0,648,648,376.0
Genesis,2013,FEMALE,0,850,5000,0,5850,108.0
Genevieve,2013,FEMALE,0,0,0,504,504,440.0
Georgia,2013,FEMALE,0,0,0,828,828,323.0
Gia,2013,FEMALE,0,0,1296,1512,2808,172.0
Gianna,2013,FEMALE,0,1360,4488,5814,11662,58.0
Giselle,2013,FEMALE,0,1188,2592,1188,4968,117.0
Gittel,2013,FEMALE,0,0,0,468,468,464.0
Gitty,2013,FEMALE,0,0,0,2664,2664,177.0
Giuliana,2013,FEMALE,0,0,0,1260,1260,269.0
Golda,2013,FEMALE,0,0,0,300,300,626.0
Goldy,2013,FEMALE,0,0,0,1152,1152,275.0
Grace,2013,FEMALE,7344,4608,5184,9360,26496,19.0
Guadalupe,2013,FEMALE,0,0,650,0,650,374.0
Hadassah,2013,FEMALE,0,0,0,468,468,464.0
Hadley,2013,FEMALE,0,0,0,504,504,440.0
Hailey,2013,FEMALE,5040,4608,13536,3312,26496,19.0
Haley,2013,FEMALE,0,0,396,0,396,543.0
Hana,2013,FEMALE,792,0,0,1368,2160,205.0
Hanna,2013,FEMALE,0,0,0,756,756,335.0
Hannah,2013,FEMALE,6624,3024,4464,14688,28800,16.0
Harmony,2013,FEMALE,0,576,0,0,576,406.0
Harper,2013,FEMALE,0,0,0,1728,1728,233.0
Hawa,2013,FEMALE,0,684,0,0,684,361.0
Haylee,2013,FEMALE,0,0,720,0,720,343.0
Hazel,2013,FEMALE,0,0,0,720,720,343.0
Heaven,2013,FEMALE,0,1584,720,0,2304,194.0
Heidi,2013,FEMALE,0,0,576,0,576,406.0
Heidy,2013,FEMALE,0,0,468,0,468,464.0
Helen,2013,FEMALE,936,0,1008,0,1944,215.0
Helena,2013,FEMALE,0,0,0,648,648,376.0
Henny,2013,FEMALE,0,0,0,936,936,303.0
Hinda,2013,FEMALE,0,0,0,360,360,580.0
Hindy,2013,FEMALE,0,0,0,1476,1476,252.0
Idy,2013,FEMALE,0,0,0,468,468,464.0
Ilana,2013,FEMALE,0,0,0,432,432,503.0
Imani,2013,FEMALE,0,792,0,0,792,328.0
Inaaya,2013,FEMALE,468,0,0,0,468,464.0
Irene,2013,FEMALE,756,0,0,0,756,335.0
Iris,2013,FEMALE,2754,0,1224,1360,5338,115.0
Isabel,2013,FEMALE,1404,0,3996,2916,8316,78.0
Isabela,2013,FEMALE,0,0,250,0,250,642.0
Isabella,2013,FEMALE,7810,6204,35860,18876,68750,1.0
Isabelle,2013,FEMALE,1650,1716,1760,2772,7898,85.0
Isis,2013,FEMALE,0,726,715,0,1441,255.0
Isla,2013,FEMALE,0,0,0,1008,1008,290.0
Itzel,2013,FEMALE,0,0,540,0,540,422.0
Ivy,2013,FEMALE,2244,0,0,880,3124,163.0
Izabella,2013,FEMALE,0,0,756,0,756,335.0
Jacqueline,2013,FEMALE,0,0,1440,1152,2592,179.0
Jada,2013,FEMALE,0,1116,0,0,1116,279.0
Jade,2013,FEMALE,0,2016,3168,0,5184,116.0
Jaliyah,2013,FEMALE,0,936,720,0,1656,236.0
Jamie,2013,FEMALE,396,0,0,0,396,543.0
Jana,2013,FEMALE,0,0,0,576,576,406.0
Janae,2013,FEMALE,0,396,0,0,396,543.0
Jane,2013,FEMALE,0,0,0,972,972,296.0
Janelle,2013,FEMALE,0,792,936,0,1728,233.0
Janiyah,2013,FEMALE,0,350,0,0,350,622.0
Jannat,2013,FEMALE,396,0,0,0,396,543.0
Jasmina,2013,FEMALE,0,0,0,360,360,580.0
Jasmine,2013,FEMALE,2736,4752,4608,1872,13968,49.0
Jayda,2013,FEMALE,0,0,250,0,250,642.0
Jayla,2013,FEMALE,0,2664,1512,0,4176,135.0
Jaylah,2013,FEMALE,0,0,864,0,864,317.0
Jaylee,2013,FEMALE,0,0,432,0,432,503.0
Jayleen,2013,FEMALE,0,0,875,0,875,316.0
Jaylene,2013,FEMALE,0,0,648,0,648,376.0
Jaylin,2013,FEMALE,0,0,684,0,684,361.0
Jazlyn,2013,FEMALE,0,0,720,0,720,343.0
Jazmin,2013,FEMALE,0,0,936,0,936,303.0
Jazmine,2013,FEMALE,0,0,468,0,468,464.0
Jenna,2013,FEMALE,1008,0,0,1440,2448,185.0
Jennifer,2013,FEMALE,1152,0,2664,0,3816,141.0
Jenny,2013,FEMALE,792,0,0,0,792,328.0
Jessica,2013,FEMALE,3312,1440,3456,2448,10656,63.0
Jessie,2013,FEMALE,360,0,0,0,360,580.0
Jimena,2013,FEMALE,0,0,612,0,612,394.0
Joanna,2013,FEMALE,1152,0,0,0,1152,275.0
Jocelyn,2013,FEMALE,1045,0,2442,0,3487,153.0
Johanna,2013,FEMALE,0,0,504,0,504,440.0
Jordan,2013,FEMALE,0,0,0,360,360,580.0
Jordyn,2013,FEMALE,0,1224,0,720,1944,215.0
Joselyn,2013,FEMALE,0,0,648,0,648,376.0
Josephine,2013,FEMALE,936,0,0,2520,3456,154.0
Journey,2013,FEMALE,0,432,0,0,432,503.0
Joy,2013,FEMALE,1008,0,0,0,1008,290.0
Joyce,2013,FEMALE,1008,0,0,1224,2232,197.0
Judy,2013,FEMALE,0,0,0,540,540,422.0
Julia,2013,FEMALE,1620,0,2484,9720,13824,51.0
Juliana,2013,FEMALE,0,0,1485,1782,3267,157.0
Julianna,2013,FEMALE,0,0,1122,1155,2277,196.0
Julie,2013,FEMALE,0,0,0,275,275,634.0
Juliet,2013,FEMALE,0,0,1155,2112,3267,157.0
Juliette,2013,FEMALE,0,0,1224,2232,3456,154.0
Julissa,2013,FEMALE,0,0,684,0,684,361.0
June,2013,FEMALE,0,0,0,468,468,464.0
Kadiatou,2013,FEMALE,0,468,0,0,468,464.0
Kailey,2013,FEMALE,0,0,648,0,648,376.0
Kailyn,2013,FEMALE,0,0,275,0,275,634.0
Kaitlyn,2013,FEMALE,3174,1656,4002,2070,10902,61.0
Kamila,2013,FEMALE,0,0,792,0,792,328.0
Karen,2013,FEMALE,864,0,1800,0,2664,177.0
Karina,2013,FEMALE,792,0,1080,0,1872,224.0
Karla,2013,FEMALE,0,0,625,0,625,393.0
Kate,2013,FEMALE,1296,0,1188,1836,4320,130.0
Katelyn,2013,FEMALE,864,0,1368,0,2232,197.0
Katelynn,2013,FEMALE,0,0,432,0,432,503.0
Katerina,2013,FEMALE,0,0,0,360,360,580.0
Katherine,2013,FEMALE,3060,0,3468,3825,10353,66.0
Katie,2013,FEMALE,0,0,900,0,900,311.0
Kayla,2013,FEMALE,2875,7728,5796,4830,21229,27.0
Kaylee,2013,FEMALE,2508,4070,10692,1320,18590,32.0
Kayleen,2013,FEMALE,0,0,612,0,612,394.0
Kaylie,2013,FEMALE,0,0,300,0,300,626.0
Kaylin,2013,FEMALE,0,1152,792,0,1944,215.0
Keira,2013,FEMALE,936,0,0,1584,2520,183.0
Kelly,2013,FEMALE,1152,0,1656,0,2808,172.0
Kelsey,2013,FEMALE,0,0,540,0,540,422.0
Kendra,2013,FEMALE,0,0,612,0,612,394.0
Kennedy,2013,FEMALE,0,972,0,0,972,296.0
Keyla,2013,FEMALE,0,0,300,0,300,626.0
Khloe,2013,FEMALE,0,2952,2736,0,5688,109.0
Kiara,2013,FEMALE,0,715,3234,0,3949,140.0
Kimberly,2013,FEMALE,1512,0,4968,0,6480,99.0
Kimora,2013,FEMALE,0,468,0,0,468,464.0
Kira,2013,FEMALE,0,0,0,300,300,626.0
Kourtney,2013,FEMALE,0,432,0,0,432,503.0
Kyla,2013,FEMALE,0,360,0,0,360,580.0
Kylee,2013,FEMALE,0,468,0,0,468,464.0
Kylie,2013,FEMALE,0,3132,4536,1728,9396,71.0
Laila,2013,FEMALE,0,3648,1600,1440,6688,97.0
Lara,2013,FEMALE,0,0,0,360,360,580.0
Laura,2013,FEMALE,0,0,858,715,1573,242.0
Lauren,2013,FEMALE,1716,1980,2376,2420,8492,77.0
Layan,2013,FEMALE,0,0,0,396,396,543.0
Layla,2013,FEMALE,1150,3312,7590,5658,17710,36.0
Lea,2013,FEMALE,0,0,0,828,828,323.0
Leah,2013,FEMALE,2898,5934,14260,24702,47794,9.0
Leanna,2013,FEMALE,0,0,360,0,360,580.0
Leela,2013,FEMALE,360,0,0,0,360,580.0
Leila,2013,FEMALE,1440,2448,3312,5040,12240,56.0
Leilani,2013,FEMALE,0,0,972,0,972,296.0
Lena,2013,FEMALE,720,0,0,1728,2448,185.0
Leona,2013,FEMALE,0,0,0,432,432,503.0
Leora,2013,FEMALE,0,0,0,396,396,543.0
Leslie,2013,FEMALE,0,0,1764,0,1764,231.0
Lesly,2013,FEMALE,0,0,684,0,684,361.0
Leyla,2013,FEMALE,0,0,550,726,1276,267.0
Lia,2013,FEMALE,0,0,1800,2016,3816,141.0
Liana,2013,FEMALE,0,0,700,900,1600,238.0
Liba,2013,FEMALE,0,0,0,468,468,464.0
Libby,2013,FEMALE,0,0,0,1224,1224,270.0
Lila,2013,FEMALE,0,0,0,972,972,296.0
Liliana,2013,FEMALE,0,0,2088,1512,3600,151.0
Lillian,2013,FEMALE,720,0,0,3312,4032,138.0
Lilly,2013,FEMALE,0,0,0,432,432,503.0
Lily,2013,FEMALE,3300,1980,1760,9130,16170,43.0
Lina,2013,FEMALE,0,0,0,468,468,464.0
Linda,2013,FEMALE,360,0,0,0,360,580.0
Litzy,2013,FEMALE,0,0,432,0,432,503.0
Liv,2013,FEMALE,0,0,0,684,684,361.0
Livia,2013,FEMALE,0,0,0,504,504,440.0
Lizbeth,2013,FEMALE,0,0,900,0,900,311.0
Lola,2013,FEMALE,0,0,792,1440,2232,197.0
London,2013,FEMALE,0,4180,2046,0,6226,106.0
Londyn,2013,FEMALE,0,500,0,0,500,463.0
Louisa,2013,FEMALE,0,0,0,504,504,440.0
Louise,2013,FEMALE,0,0,0,468,468,464.0
Lucia,2013,FEMALE,0,0,990,1045,2035,212.0
Luciana,2013,FEMALE,0,0,0,396,396,543.0
Lucille,2013,FEMALE,0,0,0,504,504,440.0
Lucy,2013,FEMALE,0,0,0,1836,1836,227.0
Luna,2013,FEMALE,0,0,2664,1152,3816,141.0
Luz,2013,FEMALE,0,0,432,0,432,503.0
Lydia,2013,FEMALE,0,0,0,360,360,580.0
Lyla,2013,FEMALE,0,0,0,648,648,376.0
Lyric,2013,FEMALE,0,504,0,0,504,440.0
Mackenzie,2013,FEMALE,0,726,0,1155,1881,222.0
Madeleine,2013,FEMALE,0,0,0,1476,1476,252.0
Madeline,2013,FEMALE,935,0,1428,5712,8075,81.0
Madelyn,2013,FEMALE,1428,0,1734,1700,4862,119.0
Madison,2013,FEMALE,4002,15410,14628,10764,44804,10.0
Madisyn,2013,FEMALE,0,432,0,0,432,503.0
Mae,2013,FEMALE,0,0,0,396,396,543.0
Maeve,2013,FEMALE,0,0,0,864,864,317.0
Maggie,2013,FEMALE,828,0,0,0,828,323.0
Maia,2013,FEMALE,0,0,396,0,396,543.0
Maite,2013,FEMALE,0,0,360,0,360,580.0
Makayla,2013,FEMALE,0,3240,1368,0,4608,125.0
Malak,2013,FEMALE,0,0,0,828,828,323.0
Malia,2013,FEMALE,0,2016,720,0,2736,174.0
Maliyah,2013,FEMALE,0,400,0,0,400,541.0
Malka,2013,FEMALE,0,0,0,2592,2592,179.0
Malky,2013,FEMALE,0,0,0,2340,2340,191.0
Manha,2013,FEMALE,504,0,0,0,504,440.0
Margaret,2013,FEMALE,0,0,0,900,900,311.0
Margaux,2013,FEMALE,0,0,0,432,432,503.0
Margot,2013,FEMALE,0,0,0,576,576,406.0
Maria,2013,FEMALE,0,0,3528,3672,7200,92.0
Mariah,2013,FEMALE,0,2016,864,0,2880,170.0
Mariam,2013,FEMALE,0,2304,0,2232,4536,127.0
Mariama,2013,FEMALE,0,720,0,0,720,343.0
Mariana,2013,FEMALE,0,0,504,0,504,440.0
Marilyn,2013,FEMALE,0,0,720,0,720,343.0
Marjorie,2013,FEMALE,0,0,504,0,504,440.0
Mary,2013,FEMALE,0,0,0,550,550,421.0
Maryam,2013,FEMALE,1155,0,0,726,1881,222.0
Matilda,2013,FEMALE,0,0,0,648,648,376.0
Maya,2013,FEMALE,2645,3036,4554,16836,27071,18.0
McKenzie,2013,FEMALE,0,612,0,0,612,394.0
Megan,2013,FEMALE,770,0,0,792,1562,243.0
Melanie,2013,FEMALE,0,1105,9486,1530,12121,57.0
Melany,2013,FEMALE,0,0,936,0,936,303.0
Melina,2013,FEMALE,0,0,576,0,576,406.0
Melissa,2013,FEMALE,0,0,1512,0,1512,247.0
Melody,2013,FEMALE,2052,1296,3024,0,6372,103.0
Mia,2013,FEMALE,6930,4095,24885,14070,49980,6.0
Michal,2013,FEMALE,0,0,0,360,360,580.0
Michelle,2013,FEMALE,4278,2622,5520,4140,16560,40.0
Mikayla,2013,FEMALE,0,0,0,504,504,440.0
Mila,2013,FEMALE,0,0,2592,4104,6696,96.0
Milan,2013,FEMALE,0,2016,720,0,2736,174.0
Milana,2013,FEMALE,0,0,0,684,684,361.0
Miley,2013,FEMALE,0,0,468,0,468,464.0
Mina,2013,FEMALE,0,0,0,468,468,464.0
Mindy,2013,FEMALE,0,0,0,864,864,317.0
Mira,2013,FEMALE,0,0,0,468,468,464.0
Miracle,2013,FEMALE,0,684,0,0,684,361.0
Miranda,2013,FEMALE,936,0,1152,0,2088,208.0
Mirel,2013,FEMALE,0,0,0,648,648,376.0
Miri,2013,FEMALE,0,0,0,300,300,626.0
Miriam,2013,FEMALE,0,0,605,10560,11165,59.0
Molly,2013,FEMALE,0,0,0,1476,1476,252.0
Morgan,2013,FEMALE,0,1944,0,1152,3096,164.0
Mushka,2013,FEMALE,0,0,0,432,432,503.0
Mya,2013,FEMALE,0,1584,1944,0,3528,152.0
Nadia,2013,FEMALE,0,720,0,864,1584,239.0
Nahla,2013,FEMALE,0,432,0,0,432,503.0
Naomi,2013,FEMALE,1728,6192,5040,5904,18864,31.0
Nashley,2013,FEMALE,0,0,360,0,360,580.0
Natalia,2013,FEMALE,0,0,2304,2016,4320,130.0
Natalie,2013,FEMALE,2550,0,3485,4182,10217,68.0
Natasha,2013,FEMALE,0,0,540,0,540,422.0
Nathalie,2013,FEMALE,0,0,720,0,720,343.0
Nathaly,2013,FEMALE,0,0,576,0,576,406.0
Nayeli,2013,FEMALE,0,0,468,0,468,464.0
Nechama,2013,FEMALE,0,0,0,1044,1044,285.0
Nevaeh,2013,FEMALE,0,3456,1368,0,4824,120.0
Nia,2013,FEMALE,0,1224,0,0,1224,270.0
Nicole,2013,FEMALE,3672,0,9936,4860,18468,34.0
Nina,2013,FEMALE,1836,0,1020,3570,6426,102.0
Noa,2013,FEMALE,0,0,0,756,756,335.0
Noemi,2013,FEMALE,0,0,468,0,468,464.0
Nora,2013,FEMALE,0,0,0,1908,1908,219.0
Norah,2013,FEMALE,0,0,0,540,540,422.0
Nyah,2013,FEMALE,0,0,360,0,360,580.0
Nyla,2013,FEMALE,0,2520,1656,0,4176,135.0
Nylah,2013,FEMALE,0,1872,1224,0,3096,164.0
Olive,2013,FEMALE,0,0,0,684,684,361.0
Olivia,2013,FEMALE,11990,8448,9570,30756,60764,4.0
Oumou,2013,FEMALE,0,972,0,0,972,296.0
Paige,2013,FEMALE,0,1944,0,1224,3168,160.0
Paris,2013,FEMALE,0,1440,792,0,2232,197.0
Paula,2013,FEMALE,0,0,360,0,360,580.0
Payton,2013,FEMALE,0,612,0,0,612,394.0
Pearl,2013,FEMALE,0,0,0,1116,1116,279.0
Penelope,2013,FEMALE,1188,0,5292,6372,12852,54.0
Perl,2013,FEMALE,0,0,0,468,468,464.0
Pessy,2013,FEMALE,0,0,0,1044,1044,285.0
Peyton,2013,FEMALE,0,3348,1836,1836,7020,94.0
Phoebe,2013,FEMALE,0,0,0,600,600,405.0
Phoenix,2013,FEMALE,0,432,0,0,432,503.0
Piper,2013,FEMALE,0,0,0,425,425,540.0
Poppy,2013,FEMALE,0,0,0,396,396,543.0
Precious,2013,FEMALE,0,360,0,0,360,580.0
Princess,2013,FEMALE,0,275,0,0,275,634.0
Queenie,2013,FEMALE,432,0,0,0,432,503.0
Quinn,2013,FEMALE,0,0,0,720,720,343.0
Rachel,2013,FEMALE,3264,0,1020,14960,19244,30.0
Raina,2013,FEMALE,432,0,0,0,432,503.0
Raizel,2013,FEMALE,0,0,0,540,540,422.0
Raizy,2013,FEMALE,0,0,0,2340,2340,191.0
Raquel,2013,FEMALE,0,0,360,0,360,580.0
Reagan,2013,FEMALE,0,0,0,540,540,422.0
Rebecca,2013,FEMALE,2160,0,1188,4752,8100,80.0
Reese,2013,FEMALE,0,0,0,648,648,376.0
Renee,2013,FEMALE,0,0,0,360,360,580.0
Rifky,2013,FEMALE,0,0,0,432,432,503.0
Rihanna,2013,FEMALE,0,0,504,0,504,440.0
Riley,2013,FEMALE,0,2808,1404,4428,8640,76.0
Rivka,2013,FEMALE,0,0,0,4320,4320,130.0
Rivky,2013,FEMALE,0,0,0,2160,2160,205.0
Riya,2013,FEMALE,504,0,0,0,504,440.0
Rochel,2013,FEMALE,0,0,0,1404,1404,261.0
Roiza,2013,FEMALE,0,0,0,360,360,580.0
Romy,2013,FEMALE,0,0,0,360,360,580.0
Rose,2013,FEMALE,0,0,720,3240,3960,139.0
Ruby,2013,FEMALE,0,0,792,2880,3672,148.0
Ruchy,2013,FEMALE,0,0,0,504,504,440.0
Sabina,2013,FEMALE,0,0,0,396,396,543.0
Sabrina,2013,FEMALE,1296,0,1728,2592,5616,112.0
Sadie,2013,FEMALE,0,0,0,2052,2052,211.0
Sage,2013,FEMALE,0,0,0,360,360,580.0
Saige,2013,FEMALE,0,396,0,0,396,543.0
Salma,2013,FEMALE,0,0,0,350,350,622.0
Samantha,2013,FEMALE,2898,2208,16146,6210,27462,17.0
Samara,2013,FEMALE,792,720,0,0,1512,247.0
Samiyah,2013,FEMALE,0,300,0,0,300,626.0
Sanaa,2013,FEMALE,0,504,0,0,504,440.0
Sanai,2013,FEMALE,0,504,0,0,504,440.0
Saniyah,2013,FEMALE,0,396,0,0,396,543.0
Sara,2013,FEMALE,2208,0,2320,10480,15008,47.0
Sarah,2013,FEMALE,4945,4692,6072,25116,40825,12.0
Sarai,2013,FEMALE,0,1440,1512,0,2952,168.0
Sariah,2013,FEMALE,0,468,0,0,468,464.0
Sarina,2013,FEMALE,396,0,0,0,396,543.0
Sasha,2013,FEMALE,0,792,0,770,1562,243.0
Savannah,2013,FEMALE,0,3348,4968,1944,10260,67.0
Scarlet,2013,FEMALE,0,0,756,0,756,335.0
Scarlett,2013,FEMALE,1872,1584,11088,6912,21456,26.0
Selena,2013,FEMALE,1080,0,720,0,1800,229.0
Selina,2013,FEMALE,792,0,0,0,792,328.0
Serena,2013,FEMALE,1008,0,0,864,1872,224.0
Serenity,2013,FEMALE,0,3888,3240,0,7128,93.0
Shaina,2013,FEMALE,0,0,0,864,864,317.0
Shaindel,2013,FEMALE,0,0,0,468,468,464.0
Shaindy,2013,FEMALE,0,0,0,2088,2088,208.0
Shania,2013,FEMALE,0,396,0,0,396,543.0
Sharon,2013,FEMALE,612,0,0,0,612,394.0
Shayla,2013,FEMALE,0,0,396,0,396,543.0
Sherlyn,2013,FEMALE,0,0,936,0,936,303.0
Shifra,2013,FEMALE,0,0,0,612,612,394.0
Shira,2013,FEMALE,0,0,0,720,720,343.0
Shirley,2013,FEMALE,990,0,825,0,1815,228.0
Shoshana,2013,FEMALE,0,0,0,468,468,464.0
Siena,2013,FEMALE,0,0,0,468,468,464.0
Sienna,2013,FEMALE,0,0,0,1692,1692,235.0
Sima,2013,FEMALE,0,0,0,432,432,503.0
Simone,2013,FEMALE,0,0,0,720,720,343.0
Skyla,2013,FEMALE,0,828,0,0,828,323.0
Skylah,2013,FEMALE,0,770,660,0,1430,260.0
Skylar,2013,FEMALE,0,3360,1200,2016,6576,98.0
Sloane,2013,FEMALE,0,0,0,864,864,317.0
Sofia,2013,FEMALE,3335,2070,25806,16836,48047,8.0
Sophia,2013,FEMALE,13020,3024,30555,19635,66234,2.0
Sophie,2013,FEMALE,3672,0,2592,7668,13932,50.0
Stacy,2013,FEMALE,0,0,250,0,250,642.0
Stella,2013,FEMALE,1326,0,935,6528,8789,74.0
Stephanie,2013,FEMALE,936,0,3672,0,4608,125.0
Summer,2013,FEMALE,1872,3024,1584,1584,8064,82.0
Sunny,2013,FEMALE,360,0,0,0,360,580.0
Suri,2013,FEMALE,0,0,0,468,468,464.0
Sury,2013,FEMALE,0,0,0,972,972,296.0
Sydney,2013,FEMALE,1404,2268,0,3672,7344,91.0
Syeda,2013,FEMALE,396,0,0,0,396,543.0
Sylvia,2013,FEMALE,792,0,0,720,1512,247.0
Talia,2013,FEMALE,0,1152,0,2952,4104,137.0
Tamar,2013,FEMALE,0,0,0,360,360,580.0
Tamia,2013,FEMALE,0,504,0,0,504,440.0
Tatiana,2013,FEMALE,0,0,275,0,275,634.0
Taylor,2013,FEMALE,0,6156,1836,2592,10584,64.0
Tenzin,2013,FEMALE,1116,0,0,0,1116,279.0
Tessa,2013,FEMALE,0,0,0,432,432,503.0
Tiana,2013,FEMALE,0,360,0,0,360,580.0
Tiffany,2013,FEMALE,1656,0,1296,0,2952,168.0
Tina,2013,FEMALE,468,0,0,0,468,464.0
Toby,2013,FEMALE,0,0,0,1275,1275,268.0
Tova,2013,FEMALE,0,0,0,540,540,422.0
Trany,2013,FEMALE,0,0,0,360,360,580.0
Trinity,2013,FEMALE,0,1584,720,0,2304,194.0
Tzipora,2013,FEMALE,0,0,0,576,576,406.0
Valentina,2013,FEMALE,0,0,8280,2448,10728,62.0
Valeria,2013,FEMALE,0,0,1368,0,1368,262.0
Valerie,2013,FEMALE,0,0,2750,1452,4202,134.0
Valery,2013,FEMALE,0,0,540,0,540,422.0
Vanessa,2013,FEMALE,1020,0,3876,1275,6171,107.0
Veronica,2013,FEMALE,0,0,0,720,720,343.0
Vicky,2013,FEMALE,720,0,0,0,720,343.0
Victoria,2013,FEMALE,4968,4485,15594,13800,38847,13.0
Violet,2013,FEMALE,0,0,1512,4176,5688,109.0
Vivian,2013,FEMALE,4428,0,1080,4968,10476,65.0
Vivienne,2013,FEMALE,0,0,0,900,900,311.0
Wendy,2013,FEMALE,0,0,720,0,720,343.0
Willa,2013,FEMALE,0,0,0,648,648,376.0
Winnie,2013,FEMALE,650,0,0,0,650,374.0
Wynter,2013,FEMALE,0,468,0,0,468,464.0
Ximena,2013,FEMALE,0,0,684,0,684,361.0
Yael,2013,FEMALE,0,0,0,540,540,422.0
Yamileth,2013,FEMALE,0,0,432,0,432,503.0
Yaretzi,2013,FEMALE,0,0,1332,0,1332,263.0
Yasmin,2013,FEMALE,0,0,0,504,504,440.0
Yehudis,2013,FEMALE,0,0,0,720,720,343.0
Yides,2013,FEMALE,0,0,0,684,684,361.0
Yitty,2013,FEMALE,0,0,0,1440,1440,257.0
Yocheved,2013,FEMALE,0,0,0,1008,1008,290.0
Zahra,2013,FEMALE,504,0,0,0,504,440.0
Zainab,2013,FEMALE,864,0,0,0,864,317.0
Zaniyah,2013,FEMALE,0,300,0,0,300,626.0
Zara,2013,FEMALE,2376,1080,1188,0,4644,124.0
Zariah,2013,FEMALE,0,396,0,0,396,543.0
Zelda,2013,FEMALE,0,0,0,396,396,543.0
Zissy,2013,FEMALE,0,0,0,720,720,343.0
Zoe,2013,FEMALE,6762,5175,12282,11592,35811,15.0
Zoey,2013,FEMALE,3312,4968,5382,2760,16422,42.0
Zoya,2013,FEMALE,576,0,0,0,576,406.0
Zuri,2013,FEMALE,0,576,0,0,576,406.0
Aarav,2013,MALE,612,0,0,0,612,376.0
Aaron,2013,MALE,9504,5184,17568,11664,43920,22.0
Aayan,2013,MALE,468,0,0,0,468,443.0
Abdoulaye,2013,MALE,0,648,0,0,648,360.0
Abdul,2013,MALE,720,0,0,0,720,341.0
Abdullah,2013,MALE,1296,0,0,1008,2304,198.0
Abel,2013,MALE,0,0,936,0,936,292.0
Abraham,2013,MALE,0,960,1840,11280,14080,77.0
Adam,2013,MALE,4140,2484,7314,20838,34776,34.0
Adan,2013,MALE,0,0,360,0,360,537.0
Aden,2013,MALE,0,1944,792,0,2736,179.0
Aditya,2013,MALE,468,0,0,0,468,443.0
Adonis,2013,MALE,0,792,1080,0,1872,219.0
Adrian,2013,MALE,2645,2346,18630,5520,29141,41.0
Adriel,2013,MALE,0,0,936,0,936,292.0
Adyan,2013,MALE,468,0,0,0,468,443.0
Aharon,2013,MALE,0,0,0,684,684,352.0
Ahmad,2013,MALE,0,0,0,360,360,537.0
Ahmed,2013,MALE,1188,0,0,1595,2783,177.0
Ahnaf,2013,MALE,396,0,0,0,396,506.0
Aidan,2013,MALE,3450,3565,4416,4554,15985,65.0
Aiden,2013,MALE,16272,19152,26208,9648,71280,6.0
Akiva,2013,MALE,0,0,0,1080,1080,270.0
Alan,2013,MALE,2592,0,6804,2700,12096,84.0
Albert,2013,MALE,1584,0,1440,0,3024,172.0
Alberto,2013,MALE,0,0,468,0,468,443.0
Alec,2013,MALE,0,0,0,396,396,506.0
Alejandro,2013,MALE,0,0,2556,0,2556,186.0
Alex,2013,MALE,5175,2208,7176,4830,19389,59.0
Alexander,2013,MALE,6490,4488,24750,27192,62920,10.0
Alexis,2013,MALE,0,0,1050,0,1050,274.0
Alfredo,2013,MALE,0,0,432,0,432,469.0
Ali,2013,MALE,1584,0,0,2664,4248,149.0
Allan,2013,MALE,0,0,275,0,275,589.0
Allen,2013,MALE,864,0,0,0,864,307.0
Alonso,2013,MALE,0,0,360,0,360,537.0
Alpha,2013,MALE,0,396,0,0,396,506.0
Alvin,2013,MALE,1368,0,0,0,1368,244.0
Amadou,2013,MALE,0,576,0,0,576,385.0
Amar'e,2013,MALE,0,432,0,0,432,469.0
Amare,2013,MALE,0,540,0,0,540,402.0
Amari,2013,MALE,0,1188,0,0,1188,259.0
Amir,2013,MALE,0,10404,2448,2635,15487,70.0
Anderson,2013,MALE,0,0,1296,0,1296,249.0
Andre,2013,MALE,0,750,650,0,1400,243.0
Andres,2013,MALE,0,0,1044,0,1044,275.0
Andrew,2013,MALE,5060,3174,10764,16560,35558,33.0
Andy,2013,MALE,2592,0,2232,0,4824,138.0
Angel,2013,MALE,0,0,7848,0,7848,108.0
Angelo,2013,MALE,0,0,1100,1320,2420,193.0
Anson,2013,MALE,792,0,0,0,792,324.0
Anthony,2013,MALE,5184,6912,26640,17856,56592,15.0
Anton,2013,MALE,0,0,0,396,396,506.0
Antonio,2013,MALE,0,1105,2958,2958,7021,115.0
Archer,2013,MALE,0,0,0,468,468,443.0
Ari,2013,MALE,0,0,0,1116,1116,265.0
Arian,2013,MALE,0,0,396,0,396,506.0
Ariel,2013,MALE,0,0,715,990,1705,229.0
Arjun,2013,MALE,720,0,0,0,720,341.0
Armani,2013,MALE,0,0,648,0,648,360.0
Aron,2013,MALE,0,0,0,2808,2808,175.0
Arthur,2013,MALE,0,0,0,1188,1188,259.0
Aryan,2013,MALE,864,0,0,0,864,307.0
Arye,2013,MALE,0,0,0,432,432,469.0
Aryeh,2013,MALE,0,0,0,900,900,298.0
Asher,2013,MALE,550,0,0,3366,3916,159.0
Ashton,2013,MALE,0,1656,864,0,2520,187.0
August,2013,MALE,0,0,0,972,972,285.0
Austin,2013,MALE,6996,3080,5016,3190,18282,60.0
Avery,2013,MALE,1518,2622,1495,2346,7981,107.0
Avi,2013,MALE,0,0,0,396,396,506.0
Avraham,2013,MALE,0,0,0,1728,1728,225.0
Avrohom,2013,MALE,0,0,0,1116,1116,265.0
Avrum,2013,MALE,0,0,0,612,612,376.0
Axel,2013,MALE,0,0,3960,720,4680,141.0
Ayaan,2013,MALE,1620,0,0,0,1620,232.0
Ayan,2013,MALE,900,0,0,0,900,298.0
Ayden,2013,MALE,1728,5292,7884,0,14904,73.0
Baruch,2013,MALE,0,0,0,540,540,402.0
Beckett,2013,MALE,0,0,0,468,468,443.0
Ben,2013,MALE,0,0,0,936,936,292.0
Benjamin,2013,MALE,4320,4464,8784,33408,50976,19.0
Bennett,2013,MALE,0,0,0,504,504,420.0
Benson,2013,MALE,432,0,0,0,432,469.0
Benzion,2013,MALE,0,0,0,720,720,341.0
Binyomin,2013,MALE,0,0,0,360,360,537.0
Blake,2013,MALE,0,2125,1734,2754,6613,119.0
Boruch,2013,MALE,0,0,0,468,468,443.0
Boubacar,2013,MALE,0,468,0,0,468,443.0
Bowen,2013,MALE,360,0,0,0,360,537.0
Bradley,2013,MALE,0,1404,2268,1080,4752,139.0
Brady,2013,MALE,0,0,0,400,400,502.0
Brandon,2013,MALE,4620,4620,14080,4752,28072,43.0
Brayan,2013,MALE,0,0,792,0,792,324.0
Brayden,2013,MALE,1152,0,800,1440,3392,166.0
Brendan,2013,MALE,720,0,0,1368,2088,207.0
Brian,2013,MALE,7056,1440,5472,3168,17136,62.0
Brody,2013,MALE,0,0,0,550,550,400.0
Bruce,2013,MALE,0,0,432,0,432,469.0
Bryan,2013,MALE,1728,0,5616,0,7344,113.0
Bryant,2013,MALE,0,0,432,0,432,469.0
Bryce,2013,MALE,0,1700,0,550,2250,200.0
Bryson,2013,MALE,0,468,0,0,468,443.0
Byron,2013,MALE,0,0,756,0,756,331.0
Caiden,2013,MALE,0,648,0,0,648,360.0
Cairo,2013,MALE,0,432,0,0,432,469.0
Caleb,2013,MALE,4464,8208,6480,4464,23616,51.0
Calvin,2013,MALE,350,0,0,0,350,581.0
Camden,2013,MALE,0,396,0,0,396,506.0
Cameron,2013,MALE,0,4998,1938,2295,9231,102.0
Camilo,2013,MALE,0,0,396,0,396,506.0
Camren,2013,MALE,0,396,0,0,396,506.0
Carlos,2013,MALE,0,0,2988,0,2988,173.0
Carmelo,2013,MALE,0,0,504,0,504,420.0
Carson,2013,MALE,360,0,0,0,360,537.0
Carter,2013,MALE,1518,8418,1955,4002,15893,67.0
Cayden,2013,MALE,0,1656,936,0,2592,181.0
Cesar,2013,MALE,0,0,1044,0,1044,275.0
Chaim,2013,MALE,0,0,0,5400,5400,131.0
Chance,2013,MALE,0,828,0,0,828,312.0
Charles,2013,MALE,2592,2160,0,14688,19440,58.0
Charlie,2013,MALE,0,0,1152,1728,2880,174.0
Chase,2013,MALE,0,5832,1836,2808,10476,95.0
Cheskel,2013,MALE,0,0,0,432,432,469.0
Chesky,2013,MALE,0,0,0,468,468,443.0
Chris,2013,MALE,1188,1296,2160,0,4644,142.0
Christian,2013,MALE,2592,11376,15264,7200,36432,32.0
Christopher,2013,MALE,4002,7590,19665,12006,43263,24.0
Cole,2013,MALE,0,0,0,792,792,324.0
Colin,2013,MALE,792,0,0,2664,3456,163.0
Colton,2013,MALE,0,0,0,504,504,420.0
Connor,2013,MALE,2208,1360,0,4080,7648,110.0
Conor,2013,MALE,0,0,0,612,612,376.0
Cooper,2013,MALE,0,0,0,900,900,298.0
Corey,2013,MALE,0,432,0,0,432,469.0
Cristian,2013,MALE,0,0,1692,0,1692,230.0
Cristopher,2013,MALE,0,0,396,0,396,506.0
Damian,2013,MALE,0,0,3384,864,4248,149.0
Damien,2013,MALE,0,0,432,0,432,469.0
Damon,2013,MALE,360,0,0,0,360,537.0
Daniel,2013,MALE,11340,6300,23730,29358,70728,7.0
Danny,2013,MALE,1080,0,1368,0,2448,189.0
Dante,2013,MALE,0,0,936,1008,1944,216.0
Dariel,2013,MALE,0,0,1044,0,1044,275.0
Darius,2013,MALE,0,432,0,0,432,469.0
Darren,2013,MALE,972,0,0,0,972,285.0
Darwin,2013,MALE,0,0,756,0,756,331.0
David,2013,MALE,6048,7344,26784,43776,83952,2.0
Dean,2013,MALE,0,0,864,1656,2520,187.0
Declan,2013,MALE,0,0,0,1440,1440,239.0
Dennis,2013,MALE,0,0,0,432,432,469.0
Denzel,2013,MALE,0,0,504,0,504,420.0
Dereck,2013,MALE,0,0,396,0,396,506.0
Derek,2013,MALE,1728,0,3384,0,5112,136.0
Derrick,2013,MALE,0,360,0,0,360,537.0
Desmond,2013,MALE,0,0,0,684,684,352.0
Devin,2013,MALE,1440,1728,3456,1584,8208,106.0
Diego,2013,MALE,0,0,1836,0,1836,222.0
Dilan,2013,MALE,0,0,540,0,540,402.0
Dominic,2013,MALE,0,1944,3672,3780,9396,101.0
Dominick,2013,MALE,0,1020,1445,1428,3893,160.0
Dov,2013,MALE,0,0,0,972,972,285.0
Dovid,2013,MALE,0,0,0,1224,1224,258.0
Duvid,2013,MALE,0,0,0,360,360,537.0
Dylan,2013,MALE,6480,6624,38880,19584,71568,5.0
Eason,2013,MALE,1152,0,0,0,1152,261.0
Eddie,2013,MALE,432,0,0,0,432,469.0
Eden,2013,MALE,360,0,0,0,360,537.0
Edgar,2013,MALE,0,0,756,0,756,331.0
Edison,2013,MALE,0,0,540,0,540,402.0
Eduardo,2013,MALE,0,0,792,0,792,324.0
Edward,2013,MALE,1512,0,5508,3564,10584,94.0
Edwin,2013,MALE,936,0,2592,0,3528,162.0
Efraim,2013,MALE,0,0,0,648,648,360.0
Eitan,2013,MALE,0,0,0,576,576,385.0
Elan,2013,MALE,0,0,0,432,432,469.0
Eli,2013,MALE,1584,3744,6624,11952,23904,50.0
Eliam,2013,MALE,0,0,360,0,360,537.0
Elian,2013,MALE,0,0,756,0,756,331.0
Elias,2013,MALE,0,0,5184,1656,6840,116.0
Eliezer,2013,MALE,0,0,0,1025,1025,280.0
Elijah,2013,MALE,1575,16632,11025,3675,32907,37.0
Elimelech,2013,MALE,0,0,0,648,648,360.0
Eliyahu,2013,MALE,0,0,0,972,972,285.0
Elliot,2013,MALE,0,0,0,1044,1044,275.0
Elliott,2013,MALE,0,0,0,432,432,469.0
Elvis,2013,MALE,396,0,0,0,396,506.0
Emanuel,2013,MALE,0,0,720,0,720,341.0
Emilio,2013,MALE,0,0,550,0,550,400.0
Emmanuel,2013,MALE,0,4536,5724,1296,11556,87.0
Emmett,2013,MALE,0,0,0,576,576,385.0
Eric,2013,MALE,12672,2448,5616,3744,24480,49.0
Erick,2013,MALE,0,0,2160,0,2160,205.0
Ethan,2013,MALE,18150,16060,33264,16500,83974,1.0
Evan,2013,MALE,8928,3024,8784,6048,26784,45.0
Everett,2013,MALE,0,0,0,720,720,341.0
Ezekiel,2013,MALE,0,0,300,0,300,586.0
Ezequiel,2013,MALE,0,0,396,0,396,506.0
Ezra,2013,MALE,0,0,792,3528,4320,148.0
Fabian,2013,MALE,0,0,300,0,300,586.0
Farhan,2013,MALE,396,0,0,0,396,506.0
Felipe,2013,MALE,0,0,432,0,432,469.0
Felix,2013,MALE,1955,0,2040,2244,6239,123.0
Fernando,2013,MALE,0,0,1332,0,1332,248.0
Filip,2013,MALE,0,0,0,396,396,506.0
Finn,2013,MALE,0,0,0,1008,1008,281.0
Francesco,2013,MALE,0,0,0,432,432,469.0
Francis,2013,MALE,0,0,0,468,468,443.0
Francisco,2013,MALE,0,0,1080,0,1080,270.0
Frank,2013,MALE,0,0,936,1080,2016,208.0
Frederick,2013,MALE,0,0,0,432,432,469.0
Gabriel,2013,MALE,2448,6192,19152,16704,44496,21.0
Gael,2013,MALE,0,0,2196,0,2196,203.0
Gavin,2013,MALE,3456,1872,3888,7776,16992,63.0
Gavriel,2013,MALE,0,0,0,576,576,385.0
George,2013,MALE,1512,0,1296,5940,8748,105.0
Gerard,2013,MALE,0,0,360,0,360,537.0
Giancarlo,2013,MALE,0,0,0,360,360,537.0
Gianluca,2013,MALE,0,0,0,468,468,443.0
Giovani,2013,MALE,0,0,275,0,275,589.0
Giovanni,2013,MALE,0,2592,4104,3456,10152,96.0
Giovanny,2013,MALE,0,0,432,0,432,469.0
Gordon,2013,MALE,468,0,0,0,468,443.0
Graham,2013,MALE,0,0,0,720,720,341.0
Grant,2013,MALE,0,0,0,540,540,402.0
Grayson,2013,MALE,0,0,720,1656,2376,194.0
Gregory,2013,MALE,0,1080,1188,1944,4212,151.0
Greyson,2013,MALE,0,0,0,396,396,506.0
Griffin,2013,MALE,0,0,0,576,576,385.0
Gustavo,2013,MALE,0,0,504,0,504,420.0
Hamza,2013,MALE,0,0,0,684,684,352.0
Hanley,2013,MALE,0,0,360,0,360,537.0
Harrison,2013,MALE,1296,0,0,3240,4536,143.0
Harry,2013,MALE,792,0,0,1224,2016,208.0
Hayden,2013,MALE,1122,880,0,0,2002,213.0
Hector,2013,MALE,0,0,900,0,900,298.0
Henry,2013,MALE,3564,0,3672,17388,24624,48.0
Hersh,2013,MALE,0,0,0,540,540,402.0
Hershel,2013,MALE,0,0,0,828,828,312.0
Hershy,2013,MALE,0,0,0,1080,1080,270.0
Hillel,2013,MALE,0,0,0,396,396,506.0
Hudson,2013,MALE,990,0,0,3025,4015,155.0
Hugo,2013,MALE,0,0,0,525,525,418.0
Hunter,2013,MALE,2304,2880,2592,5904,13680,80.0
Ian,2013,MALE,4176,3168,13104,4320,24768,47.0
Ibrahim,2013,MALE,2125,3468,0,2040,7633,111.0
Ibrahima,2013,MALE,0,576,0,0,576,385.0
Iker,2013,MALE,0,0,1296,0,1296,249.0
Ilan,2013,MALE,0,0,0,432,432,469.0
Isaac,2013,MALE,2750,3564,11484,13530,31328,38.0
Isaiah,2013,MALE,0,7452,6804,1188,15444,71.0
Isaias,2013,MALE,0,0,468,0,468,443.0
Ishaan,2013,MALE,275,0,0,0,275,589.0
Isiah,2013,MALE,0,396,0,0,396,506.0
Ismael,2013,MALE,0,792,1800,0,2592,181.0
Israel,2013,MALE,0,1836,1944,3672,7452,112.0
Ivan,2013,MALE,4320,0,3520,1280,9120,103.0
Jace,2013,MALE,0,3780,5292,1080,10152,96.0
Jack,2013,MALE,2268,0,3456,22896,28620,42.0
Jackson,2013,MALE,1836,0,1836,10584,14256,75.0
Jacob,2013,MALE,9108,10212,34155,29946,83421,3.0
Jaden,2013,MALE,3978,3740,6222,0,13940,79.0
Jadiel,2013,MALE,0,0,1368,0,1368,244.0
Jael,2013,MALE,0,0,828,0,828,312.0
Jahir,2013,MALE,0,0,360,0,360,537.0
Jaiden,2013,MALE,0,1368,1440,0,2808,175.0
Jair,2013,MALE,0,0,360,0,360,537.0
Jake,2013,MALE,1360,0,3672,5610,10642,93.0
Jalen,2013,MALE,0,504,0,0,504,420.0
Jamal,2013,MALE,0,432,0,0,432,469.0
Jamari,2013,MALE,0,360,0,0,360,537.0
Jamel,2013,MALE,0,275,0,0,275,589.0
James,2013,MALE,6624,3680,10902,30774,51980,18.0
Januel,2013,MALE,0,0,360,0,360,537.0
Jared,2013,MALE,0,0,900,0,900,298.0
Jariel,2013,MALE,0,0,900,0,900,298.0
Jasiah,2013,MALE,0,540,0,0,540,402.0
Jason,2013,MALE,11178,4025,9798,5106,30107,40.0
Jasper,2013,MALE,1080,0,0,1368,2448,189.0
Javier,2013,MALE,0,0,1296,0,1296,249.0
Jax,2013,MALE,0,0,0,468,468,443.0
Jaxon,2013,MALE,0,0,1008,1584,2592,181.0
Jay,2013,MALE,0,0,250,0,250,595.0
Jayce,2013,MALE,0,936,1656,0,2592,181.0
Jayceon,2013,MALE,0,648,0,0,648,360.0
Jaycob,2013,MALE,0,0,504,0,504,420.0
Jayden,2013,MALE,23100,14490,36960,4032,78582,4.0
Jaylen,2013,MALE,0,900,0,0,900,298.0
Jaylin,2013,MALE,0,360,0,0,360,537.0
Jayson,2013,MALE,0,0,648,0,648,360.0
Jean,2013,MALE,0,0,504,0,504,420.0
Jefferson,2013,MALE,0,0,468,0,468,443.0
Jeffrey,2013,MALE,864,0,2232,0,3096,169.0
Jeremiah,2013,MALE,0,8208,6768,0,14976,72.0
Jeremias,2013,MALE,0,0,432,0,432,469.0
Jeremy,2013,MALE,3168,2304,17856,1584,24912,46.0
Jerry,2013,MALE,648,0,0,0,648,360.0
Jesse,2013,MALE,0,0,0,864,864,307.0
Jesus,2013,MALE,0,0,2304,0,2304,198.0
Jimmy,2013,MALE,864,0,792,0,1656,231.0
Joaquin,2013,MALE,0,0,936,792,1728,225.0
Joel,2013,MALE,0,2160,9936,1944,14040,78.0
Johan,2013,MALE,0,0,1152,0,1152,261.0
John,2013,MALE,3600,2304,8928,24912,39744,29.0
Johnny,2013,MALE,864,0,1080,0,1944,216.0
Jonah,2013,MALE,0,0,0,1800,1800,223.0
Jonas,2013,MALE,0,0,540,0,540,402.0
Jonathan,2013,MALE,4715,5382,17388,11592,39077,31.0
Jordan,2013,MALE,2736,6624,8784,3600,21744,54.0
Jorge,2013,MALE,0,0,1404,0,1404,241.0
Jose,2013,MALE,0,0,4464,0,4464,146.0
Joseph,2013,MALE,3174,5520,19044,32545,60283,12.0
Joshua,2013,MALE,5676,13530,15950,12012,47168,20.0
Josiah,2013,MALE,0,7128,4608,0,11736,86.0
Josue,2013,MALE,0,0,1260,0,1260,255.0
Juan,2013,MALE,0,0,2448,0,2448,189.0
Judah,2013,MALE,0,0,0,864,864,307.0
Jude,2013,MALE,0,0,0,828,828,312.0
Julian,2013,MALE,2508,2970,13596,7810,26884,44.0
Julien,2013,MALE,0,0,550,726,1276,254.0
Julio,2013,MALE,0,0,828,0,828,312.0
Julius,2013,MALE,0,0,900,0,900,298.0
Junior,2013,MALE,0,0,360,0,360,537.0
Justice,2013,MALE,0,1584,864,0,2448,189.0
Justin,2013,MALE,9522,9936,19665,4140,43263,24.0
Kaden,2013,MALE,0,1008,0,0,1008,281.0
Kai,2013,MALE,2052,2160,0,2160,6372,121.0
Kaiden,2013,MALE,0,4320,2376,0,6696,118.0
Kaleb,2013,MALE,0,400,0,0,400,502.0
Kamari,2013,MALE,0,432,0,0,432,469.0
Kameron,2013,MALE,0,360,0,0,360,537.0
Kareem,2013,MALE,0,375,0,0,375,536.0
Karter,2013,MALE,0,612,0,0,612,376.0
Kayden,2013,MALE,1224,4420,4488,0,10132,98.0
Kelvin,2013,MALE,0,0,612,0,612,376.0
Kendrick,2013,MALE,0,0,720,0,720,341.0
Kenneth,2013,MALE,0,726,1595,0,2321,197.0
Kenny,2013,MALE,0,0,576,0,576,385.0
Kevin,2013,MALE,9504,5040,20016,5616,40176,27.0
Kieran,2013,MALE,0,0,0,525,525,418.0
Kimi,2013,MALE,432,0,0,0,432,469.0
King,2013,MALE,0,4176,1080,0,5256,134.0
Kingsley,2013,MALE,828,0,0,0,828,312.0
Kyle,2013,MALE,5106,2760,1610,2070,11546,88.0
Kyrie,2013,MALE,0,756,0,0,756,331.0
Laith,2013,MALE,0,0,0,360,360,537.0
Landon,2013,MALE,0,0,990,726,1716,228.0
Lawrence,2013,MALE,684,0,0,0,684,352.0
Lazer,2013,MALE,0,0,0,648,648,360.0
Leandro,2013,MALE,0,0,504,0,504,420.0
Lenny,2013,MALE,0,0,504,0,504,420.0
Leo,2013,MALE,4794,0,1734,9265,15793,68.0
Leon,2013,MALE,1620,1404,0,2700,5724,126.0
Leonard,2013,MALE,0,0,0,396,396,506.0
Leonardo,2013,MALE,0,0,3672,2088,5760,125.0
Leonel,2013,MALE,0,0,325,0,325,583.0
Lev,2013,MALE,0,0,0,504,504,420.0
Levi,2013,MALE,0,2052,1620,6156,9828,99.0
Liam,2013,MALE,9504,10340,21120,18480,59444,14.0
Lian,2013,MALE,0,0,360,0,360,537.0
Lincoln,2013,MALE,0,0,0,504,504,420.0
Lipa,2013,MALE,0,0,0,1404,1404,241.0
Logan,2013,MALE,4032,7488,11520,10224,33264,36.0
Lorenzo,2013,MALE,0,0,1000,1250,2250,200.0
Louis,2013,MALE,1632,0,1275,2754,5661,128.0
Luca,2013,MALE,0,0,1296,5544,6840,116.0
Lucas,2013,MALE,20424,3174,21528,14375,59501,13.0
Lucien,2013,MALE,0,0,0,648,648,360.0
Luis,2013,MALE,0,0,2775,0,2775,178.0
Luka,2013,MALE,0,0,0,756,756,331.0
Lukas,2013,MALE,0,0,0,540,540,402.0
Luke,2013,MALE,3744,2016,1584,14400,21744,54.0
Maison,2013,MALE,0,0,432,0,432,469.0
Major,2013,MALE,0,360,0,0,360,537.0
Malachi,2013,MALE,0,1476,0,0,1476,237.0
Malcolm,2013,MALE,0,468,0,0,468,443.0
Malik,2013,MALE,0,828,0,0,828,312.0
Mamadou,2013,MALE,0,1116,0,0,1116,265.0
Manuel,2013,MALE,0,0,800,0,800,323.0
Marc,2013,MALE,0,0,0,576,576,385.0
Marco,2013,MALE,0,0,1872,1296,3168,167.0
Marcos,2013,MALE,0,0,504,0,504,420.0
Marcus,2013,MALE,3456,2592,2592,2160,10800,92.0
Mario,2013,MALE,0,0,576,0,576,385.0
Mark,2013,MALE,0,0,936,3024,3960,157.0
Marlon,2013,MALE,0,0,360,0,360,537.0
Martin,2013,MALE,1080,0,1404,3672,6156,124.0
Marvin,2013,MALE,0,0,360,0,360,537.0
Mason,2013,MALE,6050,11110,26268,11088,54516,17.0
Massimo,2013,MALE,0,0,0,432,432,469.0
Mateo,2013,MALE,0,0,4248,1368,5616,129.0
Mathew,2013,MALE,0,0,425,0,425,501.0
Mathias,2013,MALE,0,0,504,0,504,420.0
Matias,2013,MALE,0,0,720,0,720,341.0
Matteo,2013,MALE,0,0,1008,2160,3168,167.0
Matthew,2013,MALE,7480,7392,27830,20460,63162,9.0
Mauricio,2013,MALE,0,0,360,0,360,537.0
Max,2013,MALE,2916,0,3780,11556,18252,61.0
Maxim,2013,MALE,0,0,0,936,936,292.0
Maximilian,2013,MALE,1080,0,1296,3024,5400,131.0
Maximiliano,2013,MALE,0,0,300,0,300,586.0
Maximo,2013,MALE,0,0,360,0,360,537.0
Maximus,2013,MALE,0,0,720,0,720,341.0
Maxwell,2013,MALE,1610,1518,2208,7590,12926,82.0
Mayer,2013,MALE,0,0,0,1008,1008,281.0
Mayson,2013,MALE,0,0,396,0,396,506.0
Md,2013,MALE,396,0,0,0,396,506.0
Meilech,2013,MALE,0,0,0,468,468,443.0
Meir,2013,MALE,0,0,0,1440,1440,239.0
Mekhi,2013,MALE,0,612,0,0,612,376.0
Melvin,2013,MALE,0,0,325,0,325,583.0
Menachem,2013,MALE,0,0,0,2592,2592,181.0
Mendel,2013,MALE,0,0,0,1368,1368,244.0
Mendy,2013,MALE,0,0,0,540,540,402.0
Messiah,2013,MALE,0,1548,0,0,1548,234.0
Meyer,2013,MALE,0,0,0,540,540,402.0
Micah,2013,MALE,0,2376,0,1296,3672,161.0
Michael,2013,MALE,4356,11220,17160,29260,61996,11.0
Miguel,2013,MALE,0,0,3060,0,3060,171.0
Mike,2013,MALE,0,0,450,0,450,467.0
Milan,2013,MALE,0,0,504,0,504,420.0
Miles,2013,MALE,605,0,0,3564,4169,152.0
Milo,2013,MALE,0,0,0,720,720,341.0
Mohamed,2013,MALE,0,2808,0,2880,5688,127.0
Mohammad,2013,MALE,3240,0,0,1512,4752,139.0
Mohammed,2013,MALE,1296,0,0,2160,3456,163.0
Moises,2013,MALE,0,0,648,0,648,360.0
Moishe,2013,MALE,0,0,0,540,540,402.0
Mordechai,2013,MALE,0,0,0,1975,1975,215.0
Morris,2013,MALE,0,0,0,396,396,506.0
Moses,2013,MALE,0,0,0,1116,1116,265.0
Moshe,2013,MALE,0,0,0,9432,9432,100.0
Mouhamed,2013,MALE,0,360,0,0,360,537.0
Moussa,2013,MALE,0,684,0,0,684,352.0
Muhammad,2013,MALE,11988,1512,0,2268,15768,69.0
Musa,2013,MALE,0,360,0,0,360,537.0
Myles,2013,MALE,0,792,0,720,1512,235.0
Nachman,2013,MALE,0,0,0,396,396,506.0
Naftali,2013,MALE,0,0,0,1008,1008,281.0
Naftuli,2013,MALE,0,0,0,432,432,469.0
Nasir,2013,MALE,0,972,0,0,972,285.0
Nathan,2013,MALE,6624,7314,8050,11316,33304,35.0
Nathaniel,2013,MALE,3024,6480,7344,6768,23616,51.0
Nazir,2013,MALE,0,360,0,0,360,537.0
Nehemiah,2013,MALE,0,275,0,0,275,589.0
Nelson,2013,MALE,0,0,576,0,576,385.0
Neymar,2013,MALE,0,0,576,0,576,385.0
Nicholas,2013,MALE,3190,3300,12936,20592,40018,28.0
Nico,2013,MALE,0,0,0,468,468,443.0
Nicolas,2013,MALE,0,0,4536,2016,6552,120.0
Noah,2013,MALE,5720,17556,23870,20988,68134,8.0
Noam,2013,MALE,0,0,0,756,756,331.0
Noel,2013,MALE,0,1152,1944,0,3096,169.0
Nolan,2013,MALE,1080,1404,0,2052,4536,143.0
Oliver,2013,MALE,3162,0,2448,10285,15895,66.0
Omar,2013,MALE,0,2052,3024,6264,11340,89.0
Ori,2013,MALE,0,0,0,396,396,506.0
Orion,2013,MALE,0,0,0,360,360,537.0
Oscar,2013,MALE,3996,0,3996,3240,11232,91.0
Otto,2013,MALE,0,0,0,576,576,385.0
Oumar,2013,MALE,0,450,0,0,450,467.0
Ousmane,2013,MALE,0,468,0,0,468,443.0
Owen,2013,MALE,7776,1440,2016,10512,21744,54.0
Pablo,2013,MALE,0,0,756,0,756,331.0
Parker,2013,MALE,0,0,0,1116,1116,265.0
Patrick,2013,MALE,0,1020,1632,4590,7242,114.0
Paul,2013,MALE,0,1190,1224,3060,5474,130.0
Pedro,2013,MALE,0,0,864,0,864,307.0
Peter,2013,MALE,0,0,880,4290,5170,135.0
Peyton,2013,MALE,0,576,0,0,576,385.0
Philip,2013,MALE,0,0,0,828,828,312.0
Pinchas,2013,MALE,0,0,0,360,360,537.0
Preston,2013,MALE,0,2376,1080,1944,5400,131.0
Prince,2013,MALE,0,3096,1296,0,4392,147.0
Quinn,2013,MALE,0,0,0,360,360,537.0
Rafael,2013,MALE,0,0,2376,1728,4104,153.0
Randy,2013,MALE,0,0,1296,0,1296,249.0
Raphael,2013,MALE,0,0,0,792,792,324.0
Raul,2013,MALE,0,0,792,0,792,324.0
Rayan,2013,MALE,720,0,0,1440,2160,205.0
Raymond,2013,MALE,1944,0,1080,1836,4860,137.0
Rehan,2013,MALE,396,0,0,0,396,506.0
Reid,2013,MALE,0,0,0,400,400,502.0
Rhys,2013,MALE,0,0,0,360,360,537.0
Ricardo,2013,MALE,0,0,684,0,684,352.0
Richard,2013,MALE,3036,2622,3036,3335,12029,85.0
Ricky,2013,MALE,468,0,0,0,468,443.0
Riley,2013,MALE,0,1200,1728,1040,3968,156.0
Robert,2013,MALE,0,1944,4968,9288,16200,64.0
Roberto,2013,MALE,0,0,540,0,540,402.0
Rocco,2013,MALE,0,0,0,396,396,506.0
Rodrigo,2013,MALE,0,0,400,0,400,502.0
Rohan,2013,MALE,504,0,0,0,504,420.0
Roman,2013,MALE,0,0,0,936,936,292.0
Romeo,2013,MALE,0,0,250,0,250,595.0
Ronan,2013,MALE,0,0,0,360,360,537.0
Rory,2013,MALE,0,0,0,360,360,537.0
Rowan,2013,MALE,0,0,0,504,504,420.0
Roy,2013,MALE,540,0,0,0,540,402.0
Ryan,2013,MALE,17820,7128,12540,17952,55440,16.0
Ryder,2013,MALE,0,0,0,504,504,420.0
Salvatore,2013,MALE,0,0,0,972,972,285.0
Sam,2013,MALE,0,0,0,1296,1296,249.0
Samir,2013,MALE,0,726,0,715,1441,238.0
Samuel,2013,MALE,4752,6912,9504,22752,43920,22.0
Santiago,2013,MALE,0,0,1584,0,1584,233.0
Santino,2013,MALE,0,0,0,350,350,581.0
Sawyer,2013,MALE,0,0,0,540,540,402.0
Sean,2013,MALE,2898,1656,1610,5106,11270,90.0
Sebastian,2013,MALE,1495,2898,25530,11868,41791,26.0
Sergio,2013,MALE,0,0,612,0,612,376.0
Shalom,2013,MALE,0,0,0,360,360,537.0
Shane,2013,MALE,0,1152,0,864,2016,208.0
Shawn,2013,MALE,936,1008,0,0,1944,216.0
Shaya,2013,MALE,0,0,0,756,756,331.0
Shea,2013,MALE,0,0,0,475,475,442.0
Shia,2013,MALE,0,0,0,1152,1152,261.0
Shimon,2013,MALE,0,0,0,3420,3420,165.0
Shloime,2013,MALE,0,0,0,504,504,420.0
Shloimy,2013,MALE,0,0,0,360,360,537.0
Shlome,2013,MALE,0,0,0,684,684,352.0
Shlomo,2013,MALE,0,0,0,2376,2376,194.0
Shmiel,2013,MALE,0,0,0,648,648,360.0
Shmuel,2013,MALE,0,0,0,1980,1980,214.0
Shneur,2013,MALE,0,0,0,396,396,506.0
Sholom,2013,MALE,0,0,0,684,684,352.0
Shraga,2013,MALE,0,0,0,360,360,537.0
Shulem,2013,MALE,0,0,0,1260,1260,255.0
Silas,2013,MALE,0,0,0,396,396,506.0
Simcha,2013,MALE,0,0,0,1080,1080,270.0
Simon,2013,MALE,0,0,0,2016,2016,208.0
Sincere,2013,MALE,0,612,0,0,612,376.0
Skyler,2013,MALE,0,360,0,0,360,537.0
Solomon,2013,MALE,0,0,0,1260,1260,255.0
Spencer,2013,MALE,0,0,0,936,936,292.0
Stanley,2013,MALE,1152,0,0,720,1872,219.0
Stephen,2013,MALE,0,792,0,715,1507,236.0
Steven,2013,MALE,3564,0,8100,3240,14904,73.0
Syed,2013,MALE,828,0,0,0,828,312.0
Taylor,2013,MALE,0,396,0,0,396,506.0
Tenzin,2013,MALE,625,0,0,0,625,375.0
Theo,2013,MALE,0,0,0,504,504,420.0
Theodore,2013,MALE,1122,0,0,5170,6292,122.0
Thiago,2013,MALE,0,0,1368,0,1368,244.0
Thomas,2013,MALE,1296,0,1404,11556,14256,75.0
Timothy,2013,MALE,1870,1320,1584,2970,7744,109.0
Tomas,2013,MALE,0,0,648,0,648,360.0
Tony,2013,MALE,540,0,0,0,540,402.0
Travis,2013,MALE,0,468,0,0,468,443.0
Tristan,2013,MALE,1932,6210,2898,2622,13662,81.0
Tyler,2013,MALE,5328,12960,5616,6336,30240,39.0
Tzvi,2013,MALE,0,0,0,1728,1728,225.0
Uriel,2013,MALE,0,0,648,0,648,360.0
Usher,2013,MALE,0,0,0,900,900,298.0
Valentino,2013,MALE,0,0,432,0,432,469.0
Victor,2013,MALE,1404,0,5184,2376,8964,104.0
Vihaan,2013,MALE,612,0,0,0,612,376.0
Vincent,2013,MALE,5076,0,2376,5292,12744,83.0
Walter,2013,MALE,0,0,0,468,468,443.0
Wesley,2013,MALE,1190,0,1122,1734,4046,154.0
William,2013,MALE,6710,4752,8712,19470,39644,30.0
Wilson,2013,MALE,1296,0,720,0,2016,208.0
Winston,2013,MALE,576,0,0,0,576,385.0
Wolf,2013,MALE,0,0,0,432,432,469.0
Wyatt,2013,MALE,0,0,0,1152,1152,261.0
Xander,2013,MALE,0,0,432,0,432,469.0
Xavier,2013,MALE,1728,7632,10656,2592,22608,53.0
Yaakov,2013,MALE,0,0,0,2232,2232,202.0
Yadiel,2013,MALE,0,0,720,0,720,341.0
Yahir,2013,MALE,0,0,756,0,756,331.0
Yakov,2013,MALE,0,0,0,2196,2196,203.0
Yanky,2013,MALE,0,0,0,432,432,469.0
Yariel,2013,MALE,0,0,360,0,360,537.0
Yassin,2013,MALE,0,0,0,504,504,420.0
Yechiel,2013,MALE,0,0,0,1044,1044,275.0
Yehoshua,2013,MALE,0,0,0,792,792,324.0
Yehuda,2013,MALE,0,0,0,2700,2700,180.0
Yeshaya,2013,MALE,0,0,0,396,396,506.0
Yisroel,2013,MALE,0,0,0,2376,2376,194.0
Yitzchak,2013,MALE,0,0,0,360,360,537.0
Yitzchok,2013,MALE,0,0,0,1850,1850,221.0
Yoel,2013,MALE,0,0,0,576,576,385.0
Yosef,2013,MALE,0,0,0,3960,3960,157.0
Yossi,2013,MALE,0,0,0,648,648,360.0
Yousef,2013,MALE,0,0,0,504,504,420.0
Youssef,2013,MALE,0,0,0,828,828,312.0
Yusuf,2013,MALE,0,0,0,828,828,312.0
Zachariah,2013,MALE,0,360,0,0,360,537.0
Zachary,2013,MALE,3024,3312,3600,11376,21312,57.0
Zain,2013,MALE,325,0,0,0,325,583.0
Zaire,2013,MALE,0,972,0,0,972,285.0
Zalmen,2013,MALE,0,0,0,432,432,469.0
Zayan,2013,MALE,275,0,0,0,275,589.0
Zayden,2013,MALE,0,468,0,0,468,443.0
Zev,2013,MALE,0,0,0,1764,1764,224.0
Zion,2013,MALE,0,3816,720,0,4536,143.0
Aaliyah,2014,FEMALE,0,4824,3960,0,8784,78.0
Aarya,2014,FEMALE,360,0,0,0,360,603.0
Abby,2014,FEMALE,972,0,0,0,972,300.0
Abigail,2014,FEMALE,3410,5412,11440,16368,36630,13.0
Ada,2014,FEMALE,0,0,0,432,432,511.0
Addison,2014,FEMALE,0,0,0,792,792,332.0
Adelaide,2014,FEMALE,0,0,0,684,684,356.0
Adele,2014,FEMALE,0,0,0,864,864,317.0
Adelina,2014,FEMALE,0,0,0,396,396,557.0
Adeline,2014,FEMALE,0,0,0,432,432,511.0
Adelyn,2014,FEMALE,0,0,360,0,360,603.0
Adina,2014,FEMALE,0,0,0,792,792,332.0
Adriana,2014,FEMALE,0,0,3024,1656,4680,124.0
Adrianna,2014,FEMALE,0,1188,1944,1080,4212,129.0
Ahuva,2014,FEMALE,0,0,0,550,550,420.0
Aicha,2014,FEMALE,0,828,0,0,828,324.0
Aileen,2014,FEMALE,0,0,720,0,720,349.0
Aisha,2014,FEMALE,1836,1275,0,1326,4437,125.0
Aissatou,2014,FEMALE,0,468,0,0,468,471.0
Aiza,2014,FEMALE,684,0,0,0,684,356.0
Alana,2014,FEMALE,0,1152,1224,0,2376,200.0
Alanis,2014,FEMALE,0,0,936,0,936,303.0
Aleena,2014,FEMALE,612,0,0,0,612,386.0
Alejandra,2014,FEMALE,0,0,612,0,612,386.0
Alessandra,2014,FEMALE,0,0,600,900,1500,259.0
Alessia,2014,FEMALE,0,0,0,720,720,349.0
Alexa,2014,FEMALE,0,0,5112,2664,7776,87.0
Alexandra,2014,FEMALE,1188,0,3348,9072,13608,50.0
Alexandria,2014,FEMALE,0,360,0,0,360,603.0
Alexia,2014,FEMALE,0,0,468,0,468,471.0
Alexis,2014,FEMALE,0,1326,1105,2346,4777,120.0
Alice,2014,FEMALE,2448,0,1938,4760,9146,75.0
Alicia,2014,FEMALE,792,0,770,0,1562,254.0
Alina,2014,FEMALE,4182,0,3060,1615,8857,77.0
Alisa,2014,FEMALE,792,0,0,936,1728,237.0
Alisha,2014,FEMALE,396,0,0,0,396,557.0
Alison,2014,FEMALE,0,0,756,0,756,342.0
Alissa,2014,FEMALE,0,0,360,0,360,603.0
Aliyah,2014,FEMALE,0,1656,1368,0,3024,170.0
Aliza,2014,FEMALE,0,0,0,612,612,386.0
Allison,2014,FEMALE,1620,0,11124,1512,14256,47.0
Allyson,2014,FEMALE,0,0,576,0,576,406.0
Alma,2014,FEMALE,0,0,936,792,1728,237.0
Alondra,2014,FEMALE,0,0,540,0,540,422.0
Alyssa,2014,FEMALE,2530,3312,4278,4968,15088,43.0
Amalia,2014,FEMALE,0,0,540,0,540,422.0
Amanda,2014,FEMALE,1530,0,2635,1020,5185,116.0
Amara,2014,FEMALE,0,432,0,0,432,511.0
Amaya,2014,FEMALE,0,2376,1944,0,4320,126.0
Amber,2014,FEMALE,1224,0,1296,0,2520,188.0
Amelia,2014,FEMALE,3726,3220,8280,10074,25300,23.0
Amelie,2014,FEMALE,0,0,0,360,360,603.0
Amia,2014,FEMALE,0,360,0,0,360,603.0
Amina,2014,FEMALE,1080,2916,0,2916,6912,97.0
Aminata,2014,FEMALE,0,1044,0,0,1044,290.0
Amira,2014,FEMALE,0,1080,0,1368,2448,196.0
Amirah,2014,FEMALE,0,360,0,0,360,603.0
Amiya,2014,FEMALE,0,360,0,0,360,603.0
Amiyah,2014,FEMALE,0,648,0,0,648,373.0
Amy,2014,FEMALE,2232,0,5256,0,7488,90.0
Ana,2014,FEMALE,0,0,2376,792,3168,166.0
Anabella,2014,FEMALE,0,0,360,0,360,603.0
Anabelle,2014,FEMALE,0,0,360,0,360,603.0
Anastasia,2014,FEMALE,0,0,0,936,936,303.0
Anaya,2014,FEMALE,2304,0,864,0,3168,166.0
Anayah,2014,FEMALE,360,0,0,0,360,603.0
Andrea,2014,FEMALE,0,0,1150,0,1150,281.0
Angel,2014,FEMALE,400,0,0,0,400,555.0
Angela,2014,FEMALE,5544,0,1224,0,6768,101.0
Angelica,2014,FEMALE,0,0,2160,864,3024,170.0
Angelina,2014,FEMALE,5244,1932,4692,5290,17158,35.0
Angeline,2014,FEMALE,0,0,432,0,432,511.0
Angelique,2014,FEMALE,0,0,612,0,612,386.0
Angie,2014,FEMALE,0,0,684,0,684,356.0
Anisa,2014,FEMALE,0,0,0,504,504,441.0
Aniya,2014,FEMALE,0,396,0,0,396,557.0
Aniyah,2014,FEMALE,0,612,0,0,612,386.0
Anna,2014,FEMALE,4428,0,1512,10260,16200,41.0
Annabella,2014,FEMALE,0,0,540,0,540,422.0
Annabelle,2014,FEMALE,1794,1610,1656,3588,8648,82.0
Annalise,2014,FEMALE,0,0,432,0,432,511.0
Anne,2014,FEMALE,1008,0,0,720,1728,237.0
Annie,2014,FEMALE,1080,0,0,0,1080,285.0
Antonia,2014,FEMALE,0,0,0,612,612,386.0
Anya,2014,FEMALE,360,0,0,0,360,603.0
April,2014,FEMALE,0,0,432,0,432,511.0
Arabella,2014,FEMALE,0,0,576,0,576,406.0
Arely,2014,FEMALE,0,0,396,0,396,557.0
Aria,2014,FEMALE,3744,2736,4032,6480,16992,37.0
Ariana,2014,FEMALE,4320,3456,13536,5904,27216,19.0
Arianna,2014,FEMALE,1430,4884,9350,4092,19756,30.0
Ariel,2014,FEMALE,2016,6480,2736,1872,13104,53.0
Ariella,2014,FEMALE,0,0,1152,2304,3456,156.0
Arielle,2014,FEMALE,0,1080,936,0,2016,223.0
Arisha,2014,FEMALE,360,0,0,0,360,603.0
Arya,2014,FEMALE,2016,0,936,0,2952,174.0
Ashley,2014,FEMALE,4752,2448,20016,2016,29232,15.0
Atara,2014,FEMALE,0,0,0,468,468,471.0
Athena,2014,FEMALE,1296,0,2484,1080,4860,118.0
Aubree,2014,FEMALE,0,864,1296,0,2160,210.0
Aubrey,2014,FEMALE,0,1512,3240,0,4752,121.0
Audrey,2014,FEMALE,3348,0,1836,3564,8748,80.0
Aurora,2014,FEMALE,0,0,660,1045,1705,242.0
Autumn,2014,FEMALE,0,2952,936,0,3888,134.0
Ava,2014,FEMALE,3850,10296,8690,19272,42108,9.0
Avery,2014,FEMALE,1785,3150,2940,6930,14805,45.0
Avigail,2014,FEMALE,0,0,0,432,432,511.0
Avital,2014,FEMALE,0,0,0,360,360,603.0
Aviva,2014,FEMALE,0,0,0,504,504,441.0
Aya,2014,FEMALE,0,0,0,350,350,657.0
Ayala,2014,FEMALE,0,0,0,360,360,603.0
Ayesha,2014,FEMALE,1008,0,0,0,1008,294.0
Ayla,2014,FEMALE,0,0,0,648,648,373.0
Ayleen,2014,FEMALE,0,0,432,0,432,511.0
Aylin,2014,FEMALE,0,0,1620,0,1620,249.0
Aziza,2014,FEMALE,0,0,0,396,396,557.0
Baila,2014,FEMALE,0,0,0,1404,1404,261.0
Barbara,2014,FEMALE,0,0,0,360,360,603.0
Batsheva,2014,FEMALE,0,0,0,1152,1152,279.0
Beatrice,2014,FEMALE,0,0,0,1584,1584,251.0
Bella,2014,FEMALE,3828,1650,6820,4356,16654,38.0
Bianca,2014,FEMALE,0,0,1452,825,2277,207.0
Blake,2014,FEMALE,0,0,0,396,396,557.0
Blessing,2014,FEMALE,0,396,0,0,396,557.0
Blima,2014,FEMALE,0,0,0,725,725,347.0
Blimy,2014,FEMALE,0,0,0,972,972,300.0
Bracha,2014,FEMALE,0,0,0,792,792,332.0
Brenda,2014,FEMALE,0,0,504,0,504,441.0
Briana,2014,FEMALE,0,0,504,0,504,441.0
Brianna,2014,FEMALE,0,2592,9288,1728,13608,50.0
Bridget,2014,FEMALE,0,0,0,396,396,557.0
Brielle,2014,FEMALE,0,3240,1080,1296,5616,112.0
Brigitte,2014,FEMALE,0,0,396,0,396,557.0
Brittany,2014,FEMALE,0,0,1224,0,1224,270.0
Brooke,2014,FEMALE,0,1188,1080,3564,5832,110.0
Brooklyn,2014,FEMALE,0,504,0,0,504,441.0
Brucha,2014,FEMALE,0,0,0,468,468,471.0
Bruchy,2014,FEMALE,0,0,0,612,612,386.0
Bryanna,2014,FEMALE,0,0,432,0,432,511.0
Brynn,2014,FEMALE,0,0,0,360,360,603.0
Caitlin,2014,FEMALE,0,0,0,396,396,557.0
Cali,2014,FEMALE,0,612,0,0,612,386.0
Camila,2014,FEMALE,0,0,10615,660,11275,66.0
Camilla,2014,FEMALE,0,0,0,612,612,386.0
Camille,2014,FEMALE,0,0,0,396,396,557.0
Carina,2014,FEMALE,648,0,0,0,648,373.0
Carla,2014,FEMALE,0,0,468,0,468,471.0
Carly,2014,FEMALE,0,0,0,360,360,603.0
Carmen,2014,FEMALE,0,0,504,0,504,441.0
Carolina,2014,FEMALE,0,0,660,715,1375,264.0
Caroline,2014,FEMALE,1620,0,1080,4860,7560,89.0
Cassidy,2014,FEMALE,0,0,0,360,360,603.0
Cataleya,2014,FEMALE,0,0,432,0,432,511.0
Catalina,2014,FEMALE,0,0,475,0,475,468.0
Catherine,2014,FEMALE,2052,0,1188,3996,7236,92.0
Cecelia,2014,FEMALE,0,0,0,396,396,557.0
Cecilia,2014,FEMALE,850,0,1020,2448,4318,127.0
Celeste,2014,FEMALE,0,0,432,0,432,511.0
Celia,2014,FEMALE,0,0,0,360,360,603.0
Celine,2014,FEMALE,1296,0,1080,1080,3456,156.0
Chana,2014,FEMALE,0,0,0,3575,3575,150.0
Chanel,2014,FEMALE,0,396,0,0,396,557.0
Chany,2014,FEMALE,0,0,0,1188,1188,274.0
Charlie,2014,FEMALE,0,0,0,720,720,349.0
Charlotte,2014,FEMALE,4278,1518,4278,15295,25369,22.0
Chava,2014,FEMALE,0,0,0,1404,1404,261.0
Chavy,2014,FEMALE,0,0,0,468,468,471.0
Chaya,2014,FEMALE,0,0,0,6984,6984,96.0
Chelsea,2014,FEMALE,1105,3060,3468,0,7633,88.0
Chloe,2014,FEMALE,12765,9384,9384,11178,42711,8.0
Christina,2014,FEMALE,2448,1440,1440,1584,6912,97.0
Cindy,2014,FEMALE,900,0,0,0,900,311.0
Claire,2014,FEMALE,3528,0,0,3096,6624,103.0
Clara,2014,FEMALE,0,0,0,1296,1296,266.0
Clementine,2014,FEMALE,0,0,0,396,396,557.0
Colette,2014,FEMALE,0,0,0,540,540,422.0
Cora,2014,FEMALE,0,0,0,684,684,356.0
Crystal,2014,FEMALE,1122,0,880,0,2002,225.0
Cynthia,2014,FEMALE,1584,0,720,0,2304,202.0
Dahlia,2014,FEMALE,0,0,0,468,468,471.0
Daisy,2014,FEMALE,0,0,475,0,475,468.0
Dakota,2014,FEMALE,0,468,0,0,468,471.0
Daleyza,2014,FEMALE,0,0,504,0,504,441.0
Daniela,2014,FEMALE,0,0,1800,0,1800,234.0
Daniella,2014,FEMALE,0,0,2304,1656,3960,132.0
Danielle,2014,FEMALE,0,864,0,1656,2520,188.0
Danna,2014,FEMALE,0,0,775,0,775,340.0
Daphne,2014,FEMALE,0,0,0,576,576,406.0
Dayana,2014,FEMALE,0,0,576,0,576,406.0
Delilah,2014,FEMALE,0,0,2952,720,3672,142.0
Destiny,2014,FEMALE,0,2016,1800,0,3816,136.0
Devora,2014,FEMALE,0,0,0,828,828,324.0
Devorah,2014,FEMALE,0,0,0,1692,1692,243.0
Diana,2014,FEMALE,0,0,2376,1800,4176,130.0
Dina,2014,FEMALE,0,0,0,1008,1008,294.0
Doris,2014,FEMALE,360,0,0,0,360,603.0
Dylan,2014,FEMALE,0,0,0,1188,1188,274.0
Eden,2014,FEMALE,0,0,0,504,504,441.0
Egypt,2014,FEMALE,0,275,0,0,275,665.0
Eileen,2014,FEMALE,1296,0,792,0,2088,217.0
Elaine,2014,FEMALE,612,0,0,0,612,386.0
Eleanor,2014,FEMALE,864,0,0,4680,5544,113.0
Elena,2014,FEMALE,2052,0,3456,2916,8424,83.0
Eleni,2014,FEMALE,0,0,0,360,360,603.0
Eliana,2014,FEMALE,1518,3174,3335,6762,14789,46.0
Elina,2014,FEMALE,576,0,0,0,576,406.0
Elisa,2014,FEMALE,0,0,504,0,504,441.0
Elisheva,2014,FEMALE,0,0,0,432,432,511.0
Eliza,2014,FEMALE,0,0,726,1155,1881,229.0
Elizabeth,2014,FEMALE,2300,3450,5520,13938,25208,24.0
Ella,2014,FEMALE,4600,1518,2622,15456,24196,26.0
Elle,2014,FEMALE,0,0,0,864,864,317.0
Ellie,2014,FEMALE,1716,0,0,1705,3421,160.0
Eloise,2014,FEMALE,0,0,0,1512,1512,256.0
Elsa,2014,FEMALE,1656,0,0,936,2592,183.0
Emely,2014,FEMALE,0,0,2160,0,2160,210.0
Emerson,2014,FEMALE,0,0,0,612,612,386.0
Emilia,2014,FEMALE,0,0,1512,3888,5400,114.0
Emily,2014,FEMALE,10580,5106,23460,19734,58880,5.0
Emma,2014,FEMALE,13248,3174,23046,23575,63043,3.0
Emmeline,2014,FEMALE,0,0,0,396,396,557.0
Erica,2014,FEMALE,432,0,0,0,432,511.0
Erika,2014,FEMALE,0,0,468,0,468,471.0
Erin,2014,FEMALE,605,0,0,660,1265,268.0
Eshaal,2014,FEMALE,432,0,0,0,432,511.0
Esme,2014,FEMALE,0,0,0,504,504,441.0
Esmeralda,2014,FEMALE,0,0,684,0,684,356.0
Ester,2014,FEMALE,0,0,0,360,360,603.0
Esther,2014,FEMALE,1296,0,2160,25164,28620,16.0
Esty,2014,FEMALE,0,0,0,792,792,332.0
Etty,2014,FEMALE,0,0,0,648,648,373.0
Eva,2014,FEMALE,3864,1840,4554,10212,20470,28.0
Evangeline,2014,FEMALE,0,0,792,792,1584,251.0
Eve,2014,FEMALE,0,0,0,648,648,373.0
Evelyn,2014,FEMALE,2808,0,3456,6912,13176,52.0
Everly,2014,FEMALE,0,0,0,504,504,441.0
Evie,2014,FEMALE,0,0,0,432,432,511.0
Faiga,2014,FEMALE,0,0,0,864,864,317.0
Faigy,2014,FEMALE,0,0,0,1850,1850,232.0
Faith,2014,FEMALE,0,2200,2112,0,4312,128.0
Fanta,2014,FEMALE,0,432,0,0,432,511.0
Fatima,2014,FEMALE,2484,3456,0,1188,7128,94.0
Fatou,2014,FEMALE,0,360,0,0,360,603.0
Fatoumata,2014,FEMALE,0,1692,0,0,1692,243.0
Fiona,2014,FEMALE,2664,0,0,2592,5256,115.0
Fradel,2014,FEMALE,0,0,0,396,396,557.0
Frady,2014,FEMALE,0,0,0,350,350,657.0
Fraidy,2014,FEMALE,0,0,0,1044,1044,290.0
Frances,2014,FEMALE,0,0,0,792,792,332.0
Francesca,2014,FEMALE,0,0,864,2808,3672,142.0
Frimet,2014,FEMALE,0,0,0,432,432,511.0
Gabriela,2014,FEMALE,0,0,2970,715,3685,141.0
Gabriella,2014,FEMALE,1890,3528,8190,9765,23373,27.0
Gabrielle,2014,FEMALE,0,2664,0,1080,3744,140.0
Gemma,2014,FEMALE,0,0,0,612,612,386.0
Genesis,2014,FEMALE,0,1440,7344,0,8784,78.0
Genevieve,2014,FEMALE,0,0,0,828,828,324.0
Georgia,2014,FEMALE,0,0,0,936,936,303.0
Gia,2014,FEMALE,1122,0,1020,1734,3876,135.0
Gianna,2014,FEMALE,0,1512,4644,4104,10260,71.0
Giovanna,2014,FEMALE,0,0,0,468,468,471.0
Giselle,2014,FEMALE,0,0,1760,792,2552,187.0
Gitty,2014,FEMALE,0,0,0,2448,2448,196.0
Giuliana,2014,FEMALE,0,0,0,828,828,324.0
Golda,2014,FEMALE,0,0,0,648,648,373.0
Goldie,2014,FEMALE,0,0,0,396,396,557.0
Goldy,2014,FEMALE,0,0,0,612,612,386.0
Grace,2014,FEMALE,8832,2760,5658,9890,27140,20.0
Guadalupe,2014,FEMALE,0,0,1044,0,1044,290.0
Hadassah,2014,FEMALE,0,0,0,325,325,660.0
Hadley,2014,FEMALE,0,0,0,684,684,356.0
Hafsa,2014,FEMALE,432,0,0,0,432,511.0
Hailey,2014,FEMALE,3036,2310,10120,2904,18370,32.0
Hailie,2014,FEMALE,0,0,360,0,360,603.0
Hana,2014,FEMALE,864,0,0,864,1728,237.0
Hanna,2014,FEMALE,1080,0,0,1224,2304,202.0
Hannah,2014,FEMALE,4416,2346,2898,7360,17020,36.0
Harlow,2014,FEMALE,0,0,0,396,396,557.0
Harmony,2014,FEMALE,0,612,0,0,612,386.0
Harper,2014,FEMALE,0,0,0,1476,1476,260.0
Hawa,2014,FEMALE,0,504,0,0,504,441.0
Haylee,2014,FEMALE,0,0,375,0,375,602.0
Hazel,2014,FEMALE,0,0,792,1320,2112,215.0
Heaven,2014,FEMALE,0,1800,1080,0,2880,177.0
Heidi,2014,FEMALE,0,0,275,0,275,665.0
Helen,2014,FEMALE,0,0,1188,935,2123,214.0
Helena,2014,FEMALE,0,0,0,612,612,386.0
Henchy,2014,FEMALE,0,0,0,720,720,349.0
Henny,2014,FEMALE,0,0,0,648,648,373.0
Hinda,2014,FEMALE,0,0,0,360,360,603.0
Hindy,2014,FEMALE,0,0,0,1224,1224,270.0
Hope,2014,FEMALE,0,396,0,0,396,557.0
Imani,2014,FEMALE,0,600,0,0,600,404.0
Inaaya,2014,FEMALE,275,0,0,0,275,665.0
Inaya,2014,FEMALE,396,0,0,0,396,557.0
Irene,2014,FEMALE,576,0,0,0,576,406.0
Iris,2014,FEMALE,1512,0,0,1008,2520,188.0
Isabel,2014,FEMALE,1404,0,4536,3240,9180,74.0
Isabella,2014,FEMALE,7656,5170,36410,15444,64680,2.0
Isabelle,2014,FEMALE,3174,2760,3726,2990,12650,59.0
Isla,2014,FEMALE,0,0,0,1116,1116,282.0
Itzel,2014,FEMALE,0,0,864,0,864,317.0
Ivanna,2014,FEMALE,0,0,396,0,396,557.0
Ivy,2014,FEMALE,1500,0,0,1000,2500,194.0
Izabella,2014,FEMALE,0,0,360,0,360,603.0
Jacqueline,2014,FEMALE,0,0,1296,1152,2448,196.0
Jada,2014,FEMALE,0,648,0,0,648,373.0
Jade,2014,FEMALE,0,1210,2706,0,3916,133.0
Jana,2014,FEMALE,0,0,0,360,360,603.0
Jane,2014,FEMALE,0,0,0,900,900,311.0
Janelle,2014,FEMALE,0,432,0,0,432,511.0
Janice,2014,FEMALE,432,0,0,0,432,511.0
Jannat,2014,FEMALE,325,0,0,0,325,660.0
Jasmina,2014,FEMALE,0,0,0,396,396,557.0
Jasmine,2014,FEMALE,4968,3450,4692,2185,15295,42.0
Jayda,2014,FEMALE,0,468,0,0,468,471.0
Jayla,2014,FEMALE,0,1800,1584,0,3384,161.0
Jaylah,2014,FEMALE,0,0,540,0,540,422.0
Jayleen,2014,FEMALE,0,0,900,0,900,311.0
Jaylene,2014,FEMALE,0,0,325,0,325,660.0
Jaylin,2014,FEMALE,0,0,350,0,350,657.0
Jazlyn,2014,FEMALE,0,0,792,0,792,332.0
Jazmin,2014,FEMALE,0,0,1188,0,1188,274.0
Jenna,2014,FEMALE,0,0,0,828,828,324.0
Jennifer,2014,FEMALE,1224,0,2448,0,3672,142.0
Jenny,2014,FEMALE,500,0,0,0,500,467.0
Jessica,2014,FEMALE,3570,0,1785,1428,6783,100.0
Jessie,2014,FEMALE,1296,0,792,0,2088,217.0
Jimena,2014,FEMALE,0,0,396,0,396,557.0
Joanna,2014,FEMALE,1152,0,0,0,1152,279.0
Jocelyn,2014,FEMALE,1056,0,1760,0,2816,180.0
Jordan,2014,FEMALE,0,468,0,0,468,471.0
Jordyn,2014,FEMALE,0,1512,0,792,2304,202.0
Joselyn,2014,FEMALE,0,0,360,0,360,603.0
Josephine,2014,FEMALE,0,0,0,975,975,299.0
Journee,2014,FEMALE,0,396,0,0,396,557.0
Journey,2014,FEMALE,0,468,0,0,468,471.0
Joy,2014,FEMALE,792,792,0,0,1584,251.0
Joyce,2014,FEMALE,540,0,0,0,540,422.0
Julia,2014,FEMALE,2080,0,1920,6720,10720,68.0
Juliana,2014,FEMALE,0,0,1944,2160,4104,131.0
Julianna,2014,FEMALE,0,0,1368,1224,2592,183.0
Julie,2014,FEMALE,0,0,0,504,504,441.0
Juliet,2014,FEMALE,0,0,880,2046,2926,176.0
Juliette,2014,FEMALE,0,0,1512,2304,3816,136.0
Julissa,2014,FEMALE,0,0,540,0,540,422.0
June,2014,FEMALE,0,0,0,468,468,471.0
Juniper,2014,FEMALE,0,0,0,504,504,441.0
Kadiatou,2014,FEMALE,0,360,0,0,360,603.0
Kailey,2014,FEMALE,0,0,325,0,325,660.0
Kaitlyn,2014,FEMALE,2760,3312,2875,1380,10327,70.0
Kali,2014,FEMALE,0,432,0,0,432,511.0
Kamila,2014,FEMALE,0,0,756,0,756,342.0
Karen,2014,FEMALE,0,0,684,0,684,356.0
Karina,2014,FEMALE,468,0,0,0,468,471.0
Karla,2014,FEMALE,0,0,828,0,828,324.0
Kate,2014,FEMALE,850,0,1020,1734,3604,146.0
Katelyn,2014,FEMALE,864,0,1224,0,2088,217.0
Katherine,2014,FEMALE,3774,0,3366,3570,10710,69.0
Katie,2014,FEMALE,1080,0,864,0,1944,226.0
Kayla,2014,FEMALE,2645,4968,6072,5796,19481,31.0
Kaylee,2014,FEMALE,2484,3312,8740,2070,16606,40.0
Kayleen,2014,FEMALE,0,0,540,0,540,422.0
Kaylie,2014,FEMALE,0,0,250,0,250,668.0
Kaylin,2014,FEMALE,0,0,432,0,432,511.0
Keila,2014,FEMALE,0,0,360,0,360,603.0
Keira,2014,FEMALE,0,0,0,468,468,471.0
Kelly,2014,FEMALE,770,0,1056,0,1826,233.0
Kelsey,2014,FEMALE,0,504,0,0,504,441.0
Kendra,2014,FEMALE,0,0,396,0,396,557.0
Kennedy,2014,FEMALE,0,1800,0,720,2520,188.0
Keyla,2014,FEMALE,0,0,540,0,540,422.0
Khadija,2014,FEMALE,360,0,0,0,360,603.0
Khadijah,2014,FEMALE,0,468,0,0,468,471.0
Khloe,2014,FEMALE,0,3315,6936,1122,11373,64.0
Kiara,2014,FEMALE,0,1080,2448,0,3528,153.0
Kimberly,2014,FEMALE,0,0,2592,0,2592,183.0
Kimora,2014,FEMALE,0,468,0,0,468,471.0
Kira,2014,FEMALE,0,0,0,468,468,471.0
Kristen,2014,FEMALE,0,360,0,0,360,603.0
Kyla,2014,FEMALE,0,396,0,0,396,557.0
Kylee,2014,FEMALE,0,360,0,0,360,603.0
Kylie,2014,FEMALE,1540,3960,5720,1716,12936,57.0
Laila,2014,FEMALE,0,2754,2040,2346,7140,93.0
Lailah,2014,FEMALE,0,360,0,0,360,603.0
Lana,2014,FEMALE,0,0,0,468,468,471.0
Lara,2014,FEMALE,0,0,0,612,612,386.0
Laura,2014,FEMALE,0,0,990,1210,2200,209.0
Lauren,2014,FEMALE,0,3774,1530,3366,8670,81.0
Lauryn,2014,FEMALE,0,360,0,0,360,603.0
Layan,2014,FEMALE,0,0,0,468,468,471.0
Layla,2014,FEMALE,1430,2860,6600,7260,18150,33.0
Lea,2014,FEMALE,0,0,0,1080,1080,285.0
Leah,2014,FEMALE,3300,3960,11000,27192,45452,7.0
Leila,2014,FEMALE,0,0,1368,1008,2376,200.0
Leilani,2014,FEMALE,0,936,1296,0,2232,208.0
Lena,2014,FEMALE,0,0,0,700,700,355.0
Leora,2014,FEMALE,0,0,0,360,360,603.0
Leslie,2014,FEMALE,0,0,1224,0,1224,270.0
Lesly,2014,FEMALE,0,0,540,0,540,422.0
Leyla,2014,FEMALE,0,0,396,0,396,557.0
Lia,2014,FEMALE,0,0,1224,864,2088,217.0
Liana,2014,FEMALE,0,0,864,1080,1944,226.0
Liba,2014,FEMALE,0,0,0,828,828,324.0
Libby,2014,FEMALE,0,0,0,1080,1080,285.0
Lila,2014,FEMALE,792,0,0,3024,3816,136.0
Lilah,2014,FEMALE,0,0,0,396,396,557.0
Lilian,2014,FEMALE,0,0,0,360,360,603.0
Liliana,2014,FEMALE,0,0,1224,1584,2808,181.0
Lillian,2014,FEMALE,2016,1584,1440,5760,10800,67.0
Lilly,2014,FEMALE,0,0,0,400,400,555.0
Lily,2014,FEMALE,1512,0,2052,9504,13068,54.0
Lina,2014,FEMALE,864,0,0,936,1800,234.0
Linda,2014,FEMALE,0,0,0,360,360,603.0
Lindsay,2014,FEMALE,0,0,540,0,540,422.0
Lisa,2014,FEMALE,396,0,0,0,396,557.0
Litzy,2014,FEMALE,0,0,360,0,360,603.0
Liv,2014,FEMALE,0,0,0,576,576,406.0
Livia,2014,FEMALE,792,0,0,936,1728,237.0
Lizbeth,2014,FEMALE,0,0,475,0,475,468.0
Logan,2014,FEMALE,0,504,0,0,504,441.0
Lola,2014,FEMALE,0,0,770,1320,2090,216.0
London,2014,FEMALE,0,4392,2088,0,6480,106.0
Londyn,2014,FEMALE,0,1872,720,0,2592,183.0
Louisa,2014,FEMALE,0,0,0,432,432,511.0
Lucia,2014,FEMALE,0,0,1368,2088,3456,156.0
Luciana,2014,FEMALE,0,0,648,0,648,373.0
Lucy,2014,FEMALE,0,0,0,2088,2088,217.0
Luna,2014,FEMALE,1080,0,4536,1728,7344,91.0
Lydia,2014,FEMALE,858,0,0,770,1628,248.0
Lyla,2014,FEMALE,0,0,0,684,684,356.0
Lyric,2014,FEMALE,0,540,0,0,540,422.0
Mackenzie,2014,FEMALE,0,1620,1620,2808,6048,109.0
Madeleine,2014,FEMALE,0,0,0,1260,1260,269.0
Madeline,2014,FEMALE,1020,0,2346,5015,8381,84.0
Madelyn,2014,FEMALE,1122,0,1530,2040,4692,123.0
Madison,2014,FEMALE,3864,14950,12420,9384,40618,10.0
Madisyn,2014,FEMALE,0,504,0,0,504,441.0
Mae,2014,FEMALE,0,0,0,396,396,557.0
Maeve,2014,FEMALE,0,0,0,1080,1080,285.0
Magaly,2014,FEMALE,0,0,396,0,396,557.0
Maggie,2014,FEMALE,504,0,0,0,504,441.0
Maia,2014,FEMALE,0,0,504,0,504,441.0
Maisie,2014,FEMALE,0,0,0,504,504,441.0
Makayla,2014,FEMALE,0,2200,1056,0,3256,164.0
Malak,2014,FEMALE,0,0,0,504,504,441.0
Malaysia,2014,FEMALE,0,504,0,0,504,441.0
Malia,2014,FEMALE,0,648,0,0,648,373.0
Maliyah,2014,FEMALE,0,720,0,0,720,349.0
Malka,2014,FEMALE,0,0,0,3024,3024,170.0
Malky,2014,FEMALE,0,0,0,2520,2520,188.0
Mandy,2014,FEMALE,396,0,0,0,396,557.0
Margaret,2014,FEMALE,0,0,0,1188,1188,274.0
Margot,2014,FEMALE,0,0,0,684,684,356.0
Maria,2014,FEMALE,0,0,3135,2970,6105,108.0
Mariah,2014,FEMALE,0,1210,660,0,1870,231.0
Mariam,2014,FEMALE,0,3384,0,1368,4752,121.0
Mariama,2014,FEMALE,0,576,0,0,576,406.0
Mariana,2014,FEMALE,0,0,648,0,648,373.0
Marielle,2014,FEMALE,0,0,0,396,396,557.0
Marilyn,2014,FEMALE,0,0,468,0,468,471.0
Marjorie,2014,FEMALE,0,0,576,0,576,406.0
Mary,2014,FEMALE,0,0,0,1008,1008,294.0
Maryam,2014,FEMALE,2160,1080,0,2484,5724,111.0
Matilda,2014,FEMALE,0,0,0,450,450,509.0
Maya,2014,FEMALE,3450,4140,6210,14628,28428,18.0
McKenzie,2014,FEMALE,0,1080,0,0,1080,285.0
Megan,2014,FEMALE,936,0,1512,0,2448,196.0
Melanie,2014,FEMALE,0,1122,10812,1105,13039,55.0
Melany,2014,FEMALE,0,0,1404,0,1404,261.0
Melina,2014,FEMALE,0,0,648,0,648,373.0
Melissa,2014,FEMALE,0,0,1044,0,1044,290.0
Melody,2014,FEMALE,2016,0,1584,0,3600,147.0
Menucha,2014,FEMALE,0,0,0,468,468,471.0
Mia,2014,FEMALE,8844,6710,28050,18348,61952,4.0
Michaela,2014,FEMALE,0,0,0,468,468,471.0
Michelle,2014,FEMALE,2346,3036,5060,3174,13616,49.0
Mikaela,2014,FEMALE,0,0,396,0,396,557.0
Mikayla,2014,FEMALE,0,850,0,750,1600,250.0
Mila,2014,FEMALE,3300,1452,5060,6820,16632,39.0
Milan,2014,FEMALE,0,936,0,0,936,303.0
Milana,2014,FEMALE,0,0,0,684,684,356.0
Mina,2014,FEMALE,0,0,0,432,432,511.0
Mindy,2014,FEMALE,0,0,0,725,725,347.0
Mira,2014,FEMALE,0,0,0,425,425,550.0
Miracle,2014,FEMALE,0,325,0,0,325,660.0
Miranda,2014,FEMALE,1008,0,936,0,1944,226.0
Mirel,2014,FEMALE,0,0,0,540,540,422.0
Miriam,2014,FEMALE,0,0,0,3575,3575,150.0
Molly,2014,FEMALE,0,0,0,972,972,300.0
Monica,2014,FEMALE,0,0,432,0,432,511.0
Monserrat,2014,FEMALE,0,0,360,0,360,603.0
Montserrat,2014,FEMALE,0,0,540,0,540,422.0
Morgan,2014,FEMALE,0,2592,0,1008,3600,147.0
Mushka,2014,FEMALE,0,0,0,432,432,511.0
Mya,2014,FEMALE,0,1716,1485,0,3201,165.0
Nadia,2014,FEMALE,0,0,0,468,468,471.0
Nahla,2014,FEMALE,0,468,0,0,468,471.0
Naomi,2014,FEMALE,2160,4608,3888,7056,17712,34.0
Nashla,2014,FEMALE,0,0,684,0,684,356.0
Natalia,2014,FEMALE,0,0,2475,858,3333,162.0
Natalie,2014,FEMALE,1632,0,2856,3740,8228,85.0
Nathalie,2014,FEMALE,0,0,864,0,864,317.0
Nathaly,2014,FEMALE,0,0,684,0,684,356.0
Nayeli,2014,FEMALE,0,0,612,0,612,386.0
Nechama,2014,FEMALE,0,0,0,750,750,345.0
Nevaeh,2014,FEMALE,0,2232,936,0,3168,166.0
Nia,2014,FEMALE,0,1116,0,0,1116,282.0
Nicole,2014,FEMALE,3024,0,5184,4428,12636,60.0
Nina,2014,FEMALE,2268,0,1188,4428,7884,86.0
Noa,2014,FEMALE,0,0,0,1008,1008,294.0
Noelle,2014,FEMALE,0,0,0,468,468,471.0
Noor,2014,FEMALE,858,0,0,825,1683,245.0
Nora,2014,FEMALE,0,0,0,2520,2520,188.0
Nova,2014,FEMALE,0,396,0,0,396,557.0
Nyla,2014,FEMALE,0,2592,720,0,3312,163.0
Nylah,2014,FEMALE,0,2448,1080,0,3528,153.0
Olive,2014,FEMALE,0,0,0,684,684,356.0
Olivia,2014,FEMALE,14805,5460,12096,26040,58401,6.0
Oumou,2014,FEMALE,0,468,0,0,468,471.0
Paige,2014,FEMALE,0,3024,1512,2376,6912,97.0
Pamela,2014,FEMALE,0,0,468,0,468,471.0
Paris,2014,FEMALE,0,2088,792,0,2880,177.0
Parker,2014,FEMALE,0,0,0,425,425,550.0
Pearl,2014,FEMALE,0,0,0,828,828,324.0
Penelope,2014,FEMALE,2070,1150,8004,8694,19918,29.0
Perel,2014,FEMALE,0,0,0,684,684,356.0
Perl,2014,FEMALE,0,0,0,425,425,550.0
Perry,2014,FEMALE,0,0,0,468,468,471.0
Pessy,2014,FEMALE,0,0,0,750,750,345.0
Peyton,2014,FEMALE,0,3672,1728,1620,7020,95.0
Phoebe,2014,FEMALE,936,0,0,1944,2880,177.0
Phoenix,2014,FEMALE,0,360,0,0,360,603.0
Piper,2014,FEMALE,0,0,0,684,684,356.0
Poppy,2014,FEMALE,0,0,0,504,504,441.0
Priscilla,2014,FEMALE,360,0,0,0,360,603.0
Queena,2014,FEMALE,396,0,0,0,396,557.0
Queenie,2014,FEMALE,425,0,0,0,425,550.0
Quinn,2014,FEMALE,0,0,0,936,936,303.0
Rachel,2014,FEMALE,2592,0,1296,24624,28512,17.0
Raina,2014,FEMALE,250,0,0,0,250,668.0
Raizel,2014,FEMALE,0,0,0,540,540,422.0
Raizy,2014,FEMALE,0,0,0,3024,3024,170.0
Rebecca,2014,FEMALE,1122,0,1020,4386,6528,105.0
Reese,2014,FEMALE,0,0,0,550,550,420.0
Reizy,2014,FEMALE,0,0,0,360,360,603.0
Rena,2014,FEMALE,0,0,0,396,396,557.0
Rifky,2014,FEMALE,0,0,0,396,396,557.0
Riley,2014,FEMALE,1100,2200,1980,4092,9372,73.0
Rivka,2014,FEMALE,0,0,0,3600,3600,147.0
Rivky,2014,FEMALE,0,0,0,1872,1872,230.0
Rochel,2014,FEMALE,0,0,0,1116,1116,282.0
Roizy,2014,FEMALE,0,0,0,468,468,471.0
Rosa,2014,FEMALE,0,0,0,360,360,603.0
Rose,2014,FEMALE,0,0,2304,3960,6264,107.0
Rowan,2014,FEMALE,0,0,0,360,360,603.0
Ruby,2014,FEMALE,0,0,1584,3456,5040,117.0
Ruchel,2014,FEMALE,0,0,0,360,360,603.0
Ruchy,2014,FEMALE,0,0,0,425,425,550.0
Ruth,2014,FEMALE,0,0,720,792,1512,256.0
Sabrina,2014,FEMALE,2052,0,1944,2700,6696,102.0
Sadie,2014,FEMALE,0,0,0,1548,1548,255.0
Safa,2014,FEMALE,396,0,0,0,396,557.0
Salma,2014,FEMALE,0,0,0,360,360,603.0
Salome,2014,FEMALE,0,0,396,0,396,557.0
Samantha,2014,FEMALE,2070,1932,12558,7866,24426,25.0
Samara,2014,FEMALE,468,0,0,0,468,471.0
Samira,2014,FEMALE,0,0,0,360,360,603.0
Sanaa,2014,FEMALE,0,504,0,0,504,441.0
Sanai,2014,FEMALE,0,540,0,0,540,422.0
Saniyah,2014,FEMALE,0,250,0,0,250,668.0
Sara,2014,FEMALE,1428,0,2142,10285,13855,48.0
Sarah,2014,FEMALE,3850,2420,5148,24420,35838,14.0
Sarai,2014,FEMALE,0,1080,1224,0,2304,202.0
Sariah,2014,FEMALE,0,432,0,0,432,511.0
Sasha,2014,FEMALE,0,0,0,432,432,511.0
Savannah,2014,FEMALE,0,5406,4386,2125,11917,63.0
Scarlett,2014,FEMALE,2052,0,8640,4320,15012,44.0
Selena,2014,FEMALE,1008,0,1008,0,2016,223.0
Selina,2014,FEMALE,684,0,0,0,684,356.0
Serena,2014,FEMALE,1584,0,0,880,2464,195.0
Serenity,2014,FEMALE,0,2530,2310,0,4840,119.0
Shaina,2014,FEMALE,0,0,0,468,468,471.0
Shaindel,2014,FEMALE,0,0,0,540,540,422.0
Shaindy,2014,FEMALE,0,0,0,1375,1375,264.0
Sharon,2014,FEMALE,576,0,0,0,576,406.0
Shayna,2014,FEMALE,0,0,0,432,432,511.0
Sherlyn,2014,FEMALE,0,0,792,0,792,332.0
Shifra,2014,FEMALE,0,0,0,525,525,440.0
Shiloh,2014,FEMALE,0,360,0,0,360,603.0
Shira,2014,FEMALE,0,0,0,600,600,404.0
Shirley,2014,FEMALE,1224,0,1080,0,2304,202.0
Shoshana,2014,FEMALE,0,0,0,684,684,356.0
Shreya,2014,FEMALE,360,0,0,0,360,603.0
Siena,2014,FEMALE,0,0,0,576,576,406.0
Sienna,2014,FEMALE,0,0,550,2904,3454,159.0
Sima,2014,FEMALE,0,0,0,504,504,441.0
Simone,2014,FEMALE,0,0,0,792,792,332.0
Skye,2014,FEMALE,0,612,0,0,612,386.0
Skyla,2014,FEMALE,0,1848,880,0,2728,182.0
Skylah,2014,FEMALE,0,864,0,0,864,317.0
Skylar,2014,FEMALE,0,6804,2700,1836,11340,65.0
Skyler,2014,FEMALE,0,720,792,0,1512,256.0
Sloane,2014,FEMALE,0,0,0,900,900,311.0
Sofia,2014,FEMALE,2090,1584,21890,14520,40084,11.0
Sophia,2014,FEMALE,12210,4752,28490,22704,68156,1.0
Sophie,2014,FEMALE,3132,0,2808,6048,11988,62.0
Stella,2014,FEMALE,2052,0,1728,8424,12204,61.0
Stephanie,2014,FEMALE,1386,0,2145,0,3531,152.0
Summer,2014,FEMALE,1296,1080,0,1404,3780,139.0
Suri,2014,FEMALE,0,0,0,468,468,471.0
Sury,2014,FEMALE,0,0,0,775,775,340.0
Sydney,2014,FEMALE,0,1512,0,1656,3168,166.0
Syeda,2014,FEMALE,576,0,0,0,576,406.0
Sylvia,2014,FEMALE,792,0,0,880,1672,246.0
Sylvie,2014,FEMALE,0,0,0,360,360,603.0
Talia,2014,FEMALE,0,0,0,1764,1764,236.0
Tamar,2014,FEMALE,0,0,0,432,432,511.0
Tatiana,2014,FEMALE,0,0,432,0,432,511.0
Taylor,2014,FEMALE,0,4860,2484,2592,9936,72.0
Tenzin,2014,FEMALE,1188,0,0,0,1188,274.0
Tess,2014,FEMALE,0,0,0,396,396,557.0
Tessa,2014,FEMALE,0,0,0,468,468,471.0
Thea,2014,FEMALE,0,0,0,396,396,557.0
Tiana,2014,FEMALE,0,468,0,0,468,471.0
Tianna,2014,FEMALE,0,468,0,0,468,471.0
Tiffany,2014,FEMALE,2088,0,1440,0,3528,153.0
Toby,2014,FEMALE,0,0,0,1656,1656,247.0
Tori,2014,FEMALE,0,648,0,0,648,373.0
Trany,2014,FEMALE,0,0,0,432,432,511.0
Trinity,2014,FEMALE,0,1368,792,0,2160,210.0
Tzipora,2014,FEMALE,0,0,0,504,504,441.0
Tziporah,2014,FEMALE,0,0,0,432,432,511.0
Valentina,2014,FEMALE,0,0,9720,3240,12960,56.0
Valeria,2014,FEMALE,0,0,1224,0,1224,270.0
Valerie,2014,FEMALE,0,0,2052,0,2052,222.0
Valery,2014,FEMALE,0,0,432,0,432,511.0
Vanessa,2014,FEMALE,864,0,2088,0,2952,174.0
Vera,2014,FEMALE,0,0,0,432,432,511.0
Veronica,2014,FEMALE,0,0,0,450,450,509.0
Vicky,2014,FEMALE,540,0,0,0,540,422.0
Victoria,2014,FEMALE,3450,3450,20424,11454,38778,12.0
Violet,2014,FEMALE,0,1190,2754,4998,8942,76.0
Violeta,2014,FEMALE,0,0,432,0,432,511.0
Vivian,2014,FEMALE,2232,0,0,4392,6624,103.0
Vivienne,2014,FEMALE,0,0,0,1296,1296,266.0
Wendy,2014,FEMALE,0,0,396,0,396,557.0
Willa,2014,FEMALE,0,0,0,936,936,303.0
Winnie,2014,FEMALE,396,0,0,0,396,557.0
Winter,2014,FEMALE,0,576,0,0,576,406.0
Wynter,2014,FEMALE,0,432,0,0,432,511.0
Ximena,2014,FEMALE,0,0,936,0,936,303.0
Yael,2014,FEMALE,0,0,0,576,576,406.0
Yaretzi,2014,FEMALE,0,0,720,0,720,349.0
Yasmin,2014,FEMALE,0,0,360,0,360,603.0
Yasmina,2014,FEMALE,0,0,0,396,396,557.0
Yasmine,2014,FEMALE,0,0,0,432,432,511.0
Yehudis,2014,FEMALE,0,0,0,900,900,311.0
Yides,2014,FEMALE,0,0,0,936,936,303.0
Yitty,2014,FEMALE,0,0,0,2124,2124,213.0
Yocheved,2014,FEMALE,0,0,0,1008,1008,294.0
Zainab,2014,FEMALE,864,0,0,0,864,317.0
Zaniyah,2014,FEMALE,0,360,0,0,360,603.0
Zara,2014,FEMALE,2664,1008,0,0,3672,142.0
Zariah,2014,FEMALE,0,250,0,0,250,668.0
Zelda,2014,FEMALE,0,0,0,432,432,511.0
Zendaya,2014,FEMALE,0,468,0,0,468,471.0
Zissy,2014,FEMALE,0,0,0,900,900,311.0
Zoe,2014,FEMALE,4284,2415,9135,10080,25914,21.0
Zoey,2014,FEMALE,2520,4032,3570,2730,12852,58.0
Zuri,2014,FEMALE,0,756,0,0,756,342.0
Aahil,2014,MALE,504,0,0,0,504,416.0
Aaron,2014,MALE,9072,4896,18576,12960,45504,20.0
Aayan,2014,MALE,250,0,0,0,250,586.0
Abdoul,2014,MALE,0,396,0,0,396,500.0
Abdoulaye,2014,MALE,0,350,0,0,350,575.0
Abdullah,2014,MALE,1080,0,0,0,1080,269.0
Abel,2014,MALE,0,0,450,0,450,463.0
Abraham,2014,MALE,0,1404,3564,18576,23544,51.0
Adam,2014,MALE,4830,2760,7038,26358,40986,24.0
Adan,2014,MALE,0,0,360,0,360,538.0
Aden,2014,MALE,0,612,0,0,612,358.0
Adonis,2014,MALE,0,726,1100,0,1826,224.0
Adrian,2014,MALE,3588,1725,19320,5796,30429,41.0
Adriel,2014,MALE,0,0,1224,0,1224,259.0
Adyan,2014,MALE,612,0,0,0,612,358.0
Aharon,2014,MALE,0,0,0,525,525,415.0
Ahmad,2014,MALE,0,0,0,540,540,399.0
Ahmed,2014,MALE,1020,1020,0,3264,5304,139.0
Ahnaf,2014,MALE,396,0,0,0,396,500.0
Aidan,2014,MALE,3132,0,2592,3456,9180,109.0
Aiden,2014,MALE,14850,13310,21780,10296,60236,12.0
Akiva,2014,MALE,0,0,0,792,792,312.0
Alan,2014,MALE,3024,0,6696,1296,11016,95.0
Albert,2014,MALE,2160,0,1620,1836,5616,134.0
Alberto,2014,MALE,0,0,468,0,468,438.0
Alejandro,2014,MALE,0,0,1980,0,1980,212.0
Alex,2014,MALE,4860,0,7128,2916,14904,74.0
Alexander,2014,MALE,6732,6468,23430,24750,61380,9.0
Alexis,2014,MALE,0,0,1440,0,1440,243.0
Alfred,2014,MALE,648,0,0,0,648,347.0
Ali,2014,MALE,2142,1020,0,4590,7752,117.0
Allan,2014,MALE,0,0,468,0,468,438.0
Allen,2014,MALE,1716,0,660,0,2376,195.0
Alpha,2014,MALE,0,576,0,0,576,371.0
Alston,2014,MALE,468,0,0,0,468,438.0
Alvin,2014,MALE,1152,0,0,0,1152,263.0
Amadou,2014,MALE,0,540,0,0,540,399.0
Amare,2014,MALE,0,360,0,0,360,538.0
Amari,2014,MALE,0,1080,0,0,1080,269.0
Amir,2014,MALE,0,10908,2052,2916,15876,70.0
Anderson,2014,MALE,864,0,1224,0,2088,209.0
Andre,2014,MALE,0,325,0,0,325,578.0
Andres,2014,MALE,0,0,1080,0,1080,269.0
Andrew,2014,MALE,6615,4305,11088,9555,31563,38.0
Andy,2014,MALE,3024,0,2376,0,5400,138.0
Angel,2014,MALE,0,720,13968,0,14688,75.0
Angelo,2014,MALE,0,0,0,432,432,466.0
Anson,2014,MALE,575,0,0,0,575,394.0
Anthony,2014,MALE,4278,5106,20976,12650,43010,22.0
Anton,2014,MALE,0,0,0,396,396,500.0
Antonio,2014,MALE,0,880,2880,2016,5776,133.0
Archer,2014,MALE,0,0,0,432,432,466.0
Arham,2014,MALE,432,0,0,0,432,466.0
Ari,2014,MALE,0,0,0,1512,1512,239.0
Ariel,2014,MALE,0,0,880,1584,2464,192.0
Arjun,2014,MALE,720,0,0,0,720,329.0
Arlo,2014,MALE,0,0,0,576,576,371.0
Armaan,2014,MALE,468,0,0,0,468,438.0
Armani,2014,MALE,0,0,468,0,468,438.0
Aron,2014,MALE,0,0,0,1550,1550,238.0
Arthur,2014,MALE,0,0,0,900,900,293.0
Arvin,2014,MALE,396,0,0,0,396,500.0
Aryan,2014,MALE,648,0,0,0,648,347.0
Aryeh,2014,MALE,0,0,0,792,792,312.0
Asher,2014,MALE,1530,1105,0,7344,9979,102.0
Ashton,2014,MALE,0,3060,1326,1020,5406,137.0
August,2014,MALE,0,0,0,1008,1008,277.0
Austin,2014,MALE,9072,3168,5616,5760,23616,49.0
Avery,2014,MALE,0,1656,1656,0,3312,164.0
Avi,2014,MALE,0,0,0,396,396,500.0
Avraham,2014,MALE,0,0,0,1980,1980,212.0
Avrohom,2014,MALE,0,0,0,972,972,281.0
Avrum,2014,MALE,0,0,0,432,432,466.0
Axel,2014,MALE,0,0,3432,660,4092,153.0
Ayaan,2014,MALE,1980,0,0,0,1980,212.0
Ayan,2014,MALE,576,0,0,0,576,371.0
Ayden,2014,MALE,2160,8496,13104,1728,25488,43.0
Aydin,2014,MALE,0,0,0,396,396,500.0
Azaan,2014,MALE,360,0,0,0,360,538.0
Baruch,2014,MALE,0,0,0,576,576,371.0
Beckett,2014,MALE,0,0,0,468,468,438.0
Ben,2014,MALE,0,0,0,468,468,438.0
Benjamin,2014,MALE,6048,3150,7245,24465,40908,25.0
Bennett,2014,MALE,0,0,0,720,720,329.0
Benson,2014,MALE,828,0,0,0,828,303.0
Benzion,2014,MALE,0,0,0,450,450,463.0
Berish,2014,MALE,0,0,0,360,360,538.0
Berl,2014,MALE,0,0,0,432,432,466.0
Binyamin,2014,MALE,0,0,0,396,396,500.0
Binyomin,2014,MALE,0,0,0,396,396,500.0
Blake,2014,MALE,0,1224,0,1296,2520,186.0
Boruch,2014,MALE,0,0,0,432,432,466.0
Bradley,2014,MALE,0,990,1540,0,2530,185.0
Brady,2014,MALE,0,0,0,468,468,438.0
Brandon,2014,MALE,6480,4464,18864,4752,34560,33.0
Brayan,2014,MALE,0,0,684,0,684,337.0
Brayden,2014,MALE,1080,0,1836,1404,4320,150.0
Brendan,2014,MALE,0,0,0,432,432,466.0
Brian,2014,MALE,4896,2880,3744,2592,14112,79.0
Brody,2014,MALE,0,0,0,720,720,329.0
Brooks,2014,MALE,0,0,0,432,432,466.0
Bruce,2014,MALE,0,0,504,0,504,416.0
Bryan,2014,MALE,1275,1530,8466,0,11271,93.0
Bryant,2014,MALE,0,0,468,0,468,438.0
Bryce,2014,MALE,0,2304,936,0,3240,167.0
Bryson,2014,MALE,0,612,0,0,612,358.0
Caden,2014,MALE,0,360,0,0,360,538.0
Caiden,2014,MALE,0,648,0,0,648,347.0
Caleb,2014,MALE,3312,7920,6048,4032,21312,54.0
Calvin,2014,MALE,1080,1080,0,1512,3672,158.0
Cameron,2014,MALE,1584,5472,2736,3456,13248,83.0
Carlos,2014,MALE,0,0,3096,0,3096,172.0
Carmelo,2014,MALE,0,468,0,0,468,438.0
Carson,2014,MALE,1368,0,0,0,1368,249.0
Carter,2014,MALE,1320,13992,2508,2970,20790,57.0
Cayden,2014,MALE,0,1044,0,0,1044,274.0
Cesar,2014,MALE,0,0,828,0,828,303.0
Chaim,2014,MALE,0,0,0,4680,4680,145.0
Chance,2014,MALE,0,1008,0,0,1008,277.0
Charles,2014,MALE,2772,1210,2772,14410,21164,55.0
Charlie,2014,MALE,0,0,0,576,576,371.0
Chase,2014,MALE,1584,10080,3024,6192,20880,56.0
Cheskel,2014,MALE,0,0,0,540,540,399.0
Chris,2014,MALE,1008,0,1224,0,2232,203.0
Christian,2014,MALE,2070,10488,12420,7360,32338,36.0
Christopher,2014,MALE,2592,7920,22464,10944,43920,21.0
Cole,2014,MALE,0,0,0,1116,1116,267.0
Colin,2014,MALE,1080,0,0,2592,3672,158.0
Connor,2014,MALE,1512,0,0,3096,4608,146.0
Conor,2014,MALE,0,0,0,475,475,435.0
Cooper,2014,MALE,0,0,0,1440,1440,243.0
Cormac,2014,MALE,0,0,0,396,396,500.0
Cristian,2014,MALE,0,0,1188,0,1188,261.0
Damian,2014,MALE,0,0,3234,770,4004,155.0
Damien,2014,MALE,0,0,576,0,576,371.0
Damon,2014,MALE,612,0,0,0,612,358.0
Daniel,2014,MALE,9135,6930,21420,23415,60900,11.0
Danny,2014,MALE,0,0,612,0,612,358.0
Dante,2014,MALE,0,0,880,726,1606,237.0
Dariel,2014,MALE,0,0,1008,0,1008,277.0
Darren,2014,MALE,1080,720,0,0,1800,225.0
Darwin,2014,MALE,0,0,396,0,396,500.0
Dashiell,2014,MALE,0,0,0,360,360,538.0
David,2014,MALE,3300,6072,22044,29920,61336,10.0
Dean,2014,MALE,0,0,792,1045,1837,222.0
Declan,2014,MALE,0,0,0,1075,1075,272.0
Denis,2014,MALE,0,0,0,360,360,538.0
Dennis,2014,MALE,0,0,250,0,250,586.0
Derek,2014,MALE,3456,0,5832,1512,10800,98.0
Derick,2014,MALE,0,0,360,0,360,538.0
Devin,2014,MALE,2904,1100,1584,1430,7018,122.0
Diego,2014,MALE,0,0,2232,0,2232,203.0
Dominic,2014,MALE,0,1428,2805,2754,6987,123.0
Dominick,2014,MALE,0,0,1152,1008,2160,206.0
Donovan,2014,MALE,0,660,550,0,1210,260.0
Dov,2014,MALE,0,0,0,1368,1368,249.0
Dovid,2014,MALE,0,0,0,936,936,286.0
Drew,2014,MALE,0,0,0,432,432,466.0
Duvid,2014,MALE,0,0,0,576,576,371.0
Dylan,2014,MALE,5500,5830,38544,12408,62282,8.0
Eason,2014,MALE,1368,0,0,0,1368,249.0
Eddy,2014,MALE,0,0,250,0,250,586.0
Eden,2014,MALE,612,0,0,0,612,358.0
Edgar,2014,MALE,0,0,600,0,600,370.0
Edison,2014,MALE,504,0,0,0,504,416.0
Eduardo,2014,MALE,0,0,684,0,684,337.0
Edward,2014,MALE,1404,0,3780,4320,9504,108.0
Edwin,2014,MALE,792,0,2952,0,3744,157.0
Efraim,2014,MALE,0,0,0,468,468,438.0
Eitan,2014,MALE,0,0,0,468,468,438.0
Eli,2014,MALE,1440,2880,5616,14832,24768,45.0
Elian,2014,MALE,0,0,684,0,684,337.0
Elias,2014,MALE,0,1620,9612,3456,14688,75.0
Eliezer,2014,MALE,0,0,0,1872,1872,219.0
Elijah,2014,MALE,1794,13455,16422,3864,35535,32.0
Elimelech,2014,MALE,0,0,0,576,576,371.0
Eliyahu,2014,MALE,0,0,0,900,900,293.0
Elliot,2014,MALE,0,0,0,1188,1188,261.0
Elliott,2014,MALE,0,0,0,432,432,466.0
Ellis,2014,MALE,0,0,0,432,432,466.0
Elvis,2014,MALE,325,0,0,0,325,578.0
Emanuel,2014,MALE,0,0,864,0,864,298.0
Emiliano,2014,MALE,0,0,396,0,396,500.0
Emilio,2014,MALE,0,0,792,0,792,312.0
Emmanuel,2014,MALE,1080,3996,6912,0,11988,89.0
Emmett,2014,MALE,0,0,0,432,432,466.0
Enrique,2014,MALE,0,0,450,0,450,463.0
Enzo,2014,MALE,0,0,612,0,612,358.0
Eric,2014,MALE,9240,2090,3564,3828,18722,65.0
Erick,2014,MALE,0,0,1980,0,1980,212.0
Erik,2014,MALE,0,0,0,360,360,538.0
Esteban,2014,MALE,0,0,468,0,468,438.0
Ethan,2014,MALE,18795,14490,27510,18774,79569,4.0
Evan,2014,MALE,8208,0,5292,6264,19764,60.0
Everett,2014,MALE,0,0,0,576,576,371.0
Ezekiel,2014,MALE,0,1080,720,0,1800,225.0
Ezequiel,2014,MALE,0,0,350,0,350,575.0
Ezra,2014,MALE,0,1080,1296,4860,7236,119.0
Fabian,2014,MALE,0,0,360,0,360,538.0
Felix,2014,MALE,3564,0,1404,3456,8424,112.0
Fernando,2014,MALE,0,0,936,0,936,286.0
Filip,2014,MALE,0,0,0,396,396,500.0
Finn,2014,MALE,0,0,0,756,756,320.0
Francesco,2014,MALE,0,0,0,540,540,399.0
Francis,2014,MALE,0,0,0,468,468,438.0
Francisco,2014,MALE,0,0,825,0,825,310.0
Frank,2014,MALE,1020,0,935,1428,3383,163.0
Frederick,2014,MALE,0,0,0,576,576,371.0
Gabriel,2014,MALE,2346,5934,19044,12075,39399,26.0
Gael,2014,MALE,0,0,1368,0,1368,249.0
Gary,2014,MALE,360,0,0,0,360,538.0
Gavin,2014,MALE,2760,1380,2484,6900,13524,82.0
Gavriel,2014,MALE,0,0,0,612,612,358.0
George,2014,MALE,1275,0,2040,6630,9945,103.0
Gerardo,2014,MALE,0,0,396,0,396,500.0
Giovanni,2014,MALE,0,1620,4536,3456,9612,105.0
Giuseppe,2014,MALE,0,0,0,360,360,538.0
Gordon,2014,MALE,360,0,0,0,360,538.0
Graham,2014,MALE,0,0,0,972,972,281.0
Grant,2014,MALE,0,0,0,396,396,500.0
Grayson,2014,MALE,1296,0,1080,3240,5616,134.0
Gregory,2014,MALE,0,0,720,1080,1800,225.0
Greyson,2014,MALE,0,792,0,1008,1800,225.0
Griffin,2014,MALE,0,0,0,576,576,371.0
Hamza,2014,MALE,0,0,0,576,576,371.0
Harrison,2014,MALE,1152,0,0,3168,4320,150.0
Harry,2014,MALE,0,0,0,432,432,466.0
Hassan,2014,MALE,360,0,0,0,360,538.0
Hayden,2014,MALE,1152,0,0,720,1872,219.0
Hector,2014,MALE,0,0,648,0,648,347.0
Henry,2014,MALE,3240,0,3132,19008,25380,44.0
Hersh,2014,MALE,0,0,0,550,550,397.0
Hershel,2014,MALE,0,0,0,648,648,347.0
Hershy,2014,MALE,0,0,0,756,756,320.0
Hillel,2014,MALE,0,0,0,432,432,466.0
Hudson,2014,MALE,1836,0,1512,6264,9612,105.0
Hugo,2014,MALE,0,0,0,792,792,312.0
Hunter,2014,MALE,1980,4356,4356,4840,15532,71.0
Ian,2014,MALE,4644,0,12096,3240,19980,58.0
Ibrahim,2014,MALE,2592,2376,0,1944,6912,124.0
Ibrahima,2014,MALE,0,468,0,0,468,438.0
Iker,2014,MALE,0,0,1764,0,1764,229.0
Imran,2014,MALE,0,0,0,360,360,538.0
Isaac,2014,MALE,3630,3696,11748,13750,32824,35.0
Isaiah,2014,MALE,1296,6048,5076,0,12420,87.0
Ismael,2014,MALE,0,0,936,0,936,286.0
Israel,2014,MALE,0,0,990,2310,3300,166.0
Issac,2014,MALE,0,0,0,360,360,538.0
Ivan,2014,MALE,4386,0,3740,1530,9656,104.0
Jace,2014,MALE,0,4488,5355,1326,11169,94.0
Jack,2014,MALE,2016,0,2000,15920,19936,59.0
Jackson,2014,MALE,0,0,1386,4675,6061,129.0
Jacob,2014,MALE,6624,10074,33580,35328,85606,2.0
Jaden,2014,MALE,3240,3024,4644,0,10908,96.0
Jadiel,2014,MALE,0,0,1100,0,1100,268.0
Jael,2014,MALE,0,0,468,0,468,438.0
Jaiden,2014,MALE,0,1512,1008,0,2520,186.0
Jake,2014,MALE,1428,0,4182,3910,9520,107.0
Jakub,2014,MALE,0,0,0,396,396,500.0
Jalen,2014,MALE,0,275,0,0,275,583.0
Jamar,2014,MALE,0,432,0,0,432,466.0
James,2014,MALE,7488,5904,14256,28080,55728,15.0
Jared,2014,MALE,0,0,900,0,900,293.0
Jariel,2014,MALE,0,0,500,0,500,434.0
Jasiah,2014,MALE,0,300,0,0,300,581.0
Jason,2014,MALE,10764,3910,9660,6762,31096,39.0
Jasper,2014,MALE,1296,0,0,1728,3024,176.0
Javier,2014,MALE,0,0,1050,0,1050,273.0
Jax,2014,MALE,0,0,0,396,396,500.0
Jaxon,2014,MALE,0,1224,1700,1428,4352,149.0
Jaxson,2014,MALE,0,0,792,936,1728,233.0
Jay,2014,MALE,0,0,756,0,756,320.0
Jayce,2014,MALE,0,2376,2520,0,4896,143.0
Jayceon,2014,MALE,0,2592,936,0,3528,161.0
Jayden,2014,MALE,21505,16698,36708,4830,79741,3.0
Jaylen,2014,MALE,0,684,0,0,684,337.0
Jayson,2014,MALE,0,792,1152,0,1944,217.0
Jean,2014,MALE,0,0,792,0,792,312.0
Jefferson,2014,MALE,0,0,612,0,612,358.0
Jeffrey,2014,MALE,1224,0,1296,0,2520,186.0
Jeremiah,2014,MALE,0,8208,7056,0,15264,73.0
Jeremy,2014,MALE,3654,1470,11445,1365,17934,67.0
Jerry,2014,MALE,540,0,0,0,540,399.0
Jesse,2014,MALE,0,0,0,504,504,416.0
Jesus,2014,MALE,0,0,2412,0,2412,193.0
Jimmy,2014,MALE,684,0,0,0,684,337.0
Joaquin,2014,MALE,0,0,756,0,756,320.0
Joel,2014,MALE,0,3132,8208,3348,14688,75.0
Johan,2014,MALE,0,0,828,0,828,303.0
John,2014,MALE,2990,2760,9108,21804,36662,28.0
Johnny,2014,MALE,0,0,612,0,612,358.0
Jonah,2014,MALE,0,0,864,3240,4104,152.0
Jonas,2014,MALE,0,0,468,0,468,438.0
Jonathan,2014,MALE,4515,4830,11865,9450,30660,40.0
Jordan,2014,MALE,2346,5520,7130,4692,19688,61.0
Jorge,2014,MALE,0,0,1044,0,1044,274.0
Jose,2014,MALE,0,0,3600,0,3600,160.0
Joseph,2014,MALE,2376,2970,15048,33000,53394,17.0
Joshua,2014,MALE,4968,14904,17480,9384,46736,19.0
Josiah,2014,MALE,0,5874,2860,0,8734,111.0
Josue,2014,MALE,0,0,1260,0,1260,257.0
Juan,2014,MALE,0,0,2376,0,2376,195.0
Judah,2014,MALE,0,0,0,540,540,399.0
Jude,2014,MALE,0,0,0,625,625,357.0
Julian,2014,MALE,2244,2376,11660,9570,25850,42.0
Julio,2014,MALE,0,0,540,0,540,399.0
Julius,2014,MALE,0,1224,3312,0,4536,147.0
Junior,2014,MALE,0,0,504,0,504,416.0
Justice,2014,MALE,0,360,0,0,360,538.0
Justin,2014,MALE,8064,6192,18000,3456,35712,30.0
Kabir,2014,MALE,360,0,0,0,360,538.0
Kaden,2014,MALE,1296,2160,1080,0,4536,147.0
Kai,2014,MALE,3024,4320,1872,3312,12528,86.0
Kaiden,2014,MALE,0,4608,1440,0,6048,130.0
Kaleb,2014,MALE,0,1440,1152,0,2592,183.0
Kamari,2014,MALE,0,432,0,0,432,466.0
Karas,2014,MALE,0,0,0,360,360,538.0
Kareem,2014,MALE,0,1296,0,864,2160,206.0
Karter,2014,MALE,0,1260,0,0,1260,257.0
Kayden,2014,MALE,1728,7236,6372,0,15336,72.0
Kendrick,2014,MALE,0,0,432,0,432,466.0
Kenneth,2014,MALE,0,660,1584,0,2244,202.0
Kenny,2014,MALE,0,0,504,0,504,416.0
Kevin,2014,MALE,8928,3888,16848,2448,32112,37.0
Khalil,2014,MALE,0,468,0,0,468,438.0
Kieran,2014,MALE,0,0,0,504,504,416.0
Kimi,2014,MALE,864,0,0,0,864,298.0
King,2014,MALE,0,4752,1872,0,6624,126.0
Kingsley,2014,MALE,756,0,0,0,756,320.0
Kingston,2014,MALE,0,576,0,0,576,371.0
Kristian,2014,MALE,0,612,0,0,612,358.0
Kyle,2014,MALE,7632,4752,2016,1728,16128,69.0
Kyrie,2014,MALE,0,828,0,0,828,303.0
Landon,2014,MALE,0,1188,1620,2484,5292,140.0
Lawrence,2014,MALE,936,0,0,0,936,286.0
Lazer,2014,MALE,0,0,0,936,936,286.0
Leandro,2014,MALE,0,0,396,0,396,500.0
Leibish,2014,MALE,0,0,0,432,432,466.0
Leo,2014,MALE,5184,0,2376,11664,19224,63.0
Leon,2014,MALE,1620,0,1404,3456,6480,128.0
Leonardo,2014,MALE,1404,0,6588,3888,11880,90.0
Leonidas,2014,MALE,0,0,396,0,396,500.0
Lev,2014,MALE,0,0,0,648,648,347.0
Levi,2014,MALE,0,1040,1344,4640,7024,121.0
Liam,2014,MALE,8784,16272,44928,20016,90000,1.0
Lincoln,2014,MALE,0,0,0,396,396,500.0
Lipa,2014,MALE,0,0,0,1404,1404,247.0
Logan,2014,MALE,3312,9660,14766,7820,35558,31.0
Lorenzo,2014,MALE,0,1080,1836,2160,5076,141.0
Louis,2014,MALE,1944,0,1188,1944,5076,141.0
Luca,2014,MALE,1512,0,1944,10152,13608,81.0
Lucas,2014,MALE,15290,2640,24684,13310,55924,14.0
Lucien,2014,MALE,0,0,0,360,360,538.0
Luis,2014,MALE,0,0,3528,0,3528,161.0
Luka,2014,MALE,0,0,0,864,864,298.0
Lukas,2014,MALE,0,0,1296,1944,3240,167.0
Luke,2014,MALE,3744,1872,2448,14256,22320,53.0
Maddox,2014,MALE,0,0,360,0,360,538.0
Major,2014,MALE,0,576,0,0,576,371.0
Malachi,2014,MALE,0,1656,0,0,1656,234.0
Malik,2014,MALE,0,972,0,0,972,281.0
Mamadou,2014,MALE,0,575,0,0,575,394.0
Manuel,2014,MALE,0,0,900,0,900,293.0
Marc,2014,MALE,0,0,0,468,468,438.0
Marcel,2014,MALE,0,0,0,360,360,538.0
Marcelo,2014,MALE,0,0,432,0,432,466.0
Marco,2014,MALE,0,0,1440,1080,2520,186.0
Marcos,2014,MALE,0,0,504,0,504,416.0
Marcus,2014,MALE,3864,2484,2185,2760,11293,92.0
Mario,2014,MALE,0,0,475,0,475,435.0
Mark,2014,MALE,1020,0,1105,6222,8347,114.0
Marlon,2014,MALE,0,0,275,0,275,583.0
Martin,2014,MALE,0,0,1000,1300,2300,200.0
Marvin,2014,MALE,0,0,360,0,360,538.0
Mason,2014,MALE,7360,14490,25392,12972,60214,13.0
Mateo,2014,MALE,0,0,4356,1155,5511,136.0
Mathew,2014,MALE,0,0,648,0,648,347.0
Mathias,2014,MALE,0,0,576,0,576,371.0
Matias,2014,MALE,0,0,1152,0,1152,263.0
Matteo,2014,MALE,0,0,935,1452,2387,194.0
Matthew,2014,MALE,7810,5720,33924,17292,64746,7.0
Max,2014,MALE,2244,0,1326,9180,12750,84.0
Maxim,2014,MALE,0,0,0,936,936,286.0
Maximilian,2014,MALE,0,0,792,1440,2232,203.0
Maximiliano,2014,MALE,0,0,504,0,504,416.0
Maximus,2014,MALE,0,0,2016,1152,3168,169.0
Maxwell,2014,MALE,2040,0,1360,4590,7990,116.0
Mayer,2014,MALE,0,0,0,725,725,328.0
Meilech,2014,MALE,0,0,0,432,432,466.0
Meir,2014,MALE,0,0,0,2376,2376,195.0
Mekhi,2014,MALE,0,828,0,0,828,303.0
Melvin,2014,MALE,0,0,396,0,396,500.0
Menachem,2014,MALE,0,0,0,2950,2950,178.0
Menashe,2014,MALE,0,0,0,432,432,466.0
Mendel,2014,MALE,0,0,0,1368,1368,249.0
Mendy,2014,MALE,0,0,0,468,468,438.0
Messiah,2014,MALE,0,3528,1224,0,4752,144.0
Micah,2014,MALE,0,1760,0,1056,2816,182.0
Michael,2014,MALE,5808,8800,22968,29480,67056,6.0
Miguel,2014,MALE,0,0,2304,0,2304,199.0
Mike,2014,MALE,0,0,396,0,396,500.0
Milan,2014,MALE,0,0,2304,864,3168,169.0
Miles,2014,MALE,2880,1872,1872,8064,14688,75.0
Milo,2014,MALE,0,0,0,700,700,336.0
Misael,2014,MALE,0,0,360,0,360,538.0
Mohamed,2014,MALE,0,3096,0,3528,6624,126.0
Mohammad,2014,MALE,2268,0,0,0,2268,201.0
Mohammed,2014,MALE,3780,1296,0,2376,7452,118.0
Moises,2014,MALE,0,0,360,0,360,538.0
Moishe,2014,MALE,0,0,0,756,756,320.0
Mordche,2014,MALE,0,0,0,360,360,538.0
Mordechai,2014,MALE,0,0,0,3312,3312,164.0
Morris,2014,MALE,0,0,0,325,325,578.0
Moses,2014,MALE,0,0,0,650,650,346.0
Moshe,2014,MALE,0,0,0,6675,6675,125.0
Mouhamed,2014,MALE,0,432,0,0,432,466.0
Moussa,2014,MALE,0,576,0,0,576,371.0
Muhammad,2014,MALE,7095,0,0,1056,8151,115.0
Musa,2014,MALE,396,0,0,0,396,500.0
Myles,2014,MALE,0,935,1122,1020,3077,175.0
Naftali,2014,MALE,0,0,0,792,792,312.0
Naftuli,2014,MALE,0,0,0,612,612,358.0
Nasir,2014,MALE,0,825,0,0,825,310.0
Nathan,2014,MALE,6762,8694,9085,11316,35857,29.0
Nathaniel,2014,MALE,3312,6912,7632,6768,24624,47.0
Neil,2014,MALE,468,0,0,0,468,438.0
Nelson,2014,MALE,0,0,432,0,432,466.0
Neymar,2014,MALE,0,0,475,0,475,435.0
Nicholas,2014,MALE,3000,3100,10300,16600,33000,34.0
Nico,2014,MALE,0,0,0,360,360,538.0
Nicolas,2014,MALE,0,0,3528,2304,5832,132.0
Nikita,2014,MALE,0,0,0,396,396,500.0
Noah,2014,MALE,5544,16896,31020,15070,68530,5.0
Noam,2014,MALE,0,0,0,575,575,394.0
Noel,2014,MALE,0,936,2232,0,3168,169.0
Nolan,2014,MALE,0,1152,0,1440,2592,183.0
Nosson,2014,MALE,0,0,0,396,396,500.0
Oliver,2014,MALE,5610,0,4590,9265,19465,62.0
Omar,2014,MALE,1320,2772,2530,5390,12012,88.0
Omari,2014,MALE,0,468,0,0,468,438.0
Orlando,2014,MALE,0,0,360,0,360,538.0
Oscar,2014,MALE,2295,0,2652,3876,8823,110.0
Oumar,2014,MALE,0,504,0,0,504,416.0
Owen,2014,MALE,4080,0,1122,8874,14076,80.0
Pablo,2014,MALE,0,0,576,0,576,371.0
Parker,2014,MALE,0,0,0,972,972,281.0
Patrick,2014,MALE,0,0,0,1764,1764,229.0
Paul,2014,MALE,0,0,0,900,900,293.0
Pedro,2014,MALE,0,0,432,0,432,466.0
Peter,2014,MALE,0,0,1122,2970,4092,153.0
Peyton,2014,MALE,0,350,0,0,350,575.0
Philip,2014,MALE,0,0,0,1008,1008,277.0
Pinchas,2014,MALE,0,0,0,576,576,371.0
Pinchus,2014,MALE,0,0,0,396,396,500.0
Preston,2014,MALE,0,1152,0,936,2088,209.0
Prince,2014,MALE,0,1512,1368,0,2880,180.0
Princeton,2014,MALE,0,432,0,0,432,466.0
Quincy,2014,MALE,0,540,0,0,540,399.0
Quinn,2014,MALE,0,0,0,504,504,416.0
Rafael,2014,MALE,0,0,1440,1440,2880,180.0
Randy,2014,MALE,0,0,432,0,432,466.0
Raphael,2014,MALE,0,0,0,1044,1044,274.0
Rayan,2014,MALE,1320,0,0,1155,2475,191.0
Raymond,2014,MALE,3996,0,1836,1404,7236,119.0
Rayyan,2014,MALE,864,0,0,0,864,298.0
Reed,2014,MALE,0,0,0,396,396,500.0
Rehan,2014,MALE,468,0,0,0,468,438.0
Reid,2014,MALE,0,0,0,540,540,399.0
Reuben,2014,MALE,0,0,0,396,396,500.0
Rhys,2014,MALE,0,0,0,300,300,581.0
Ricardo,2014,MALE,0,0,550,0,550,397.0
Richard,2014,MALE,2484,2208,3105,2760,10557,100.0
Ricky,2014,MALE,360,0,0,0,360,538.0
Riley,2014,MALE,1440,2016,3312,1584,8352,113.0
Robert,2014,MALE,0,1404,3240,7236,11880,90.0
Roberto,2014,MALE,0,0,792,0,792,312.0
Rocco,2014,MALE,0,0,0,540,540,399.0
Rodrigo,2014,MALE,0,0,432,0,432,466.0
Rohan,2014,MALE,756,0,0,0,756,320.0
Roman,2014,MALE,1080,1080,0,3780,5940,131.0
Romeo,2014,MALE,0,0,504,0,504,416.0
Ronan,2014,MALE,0,0,0,756,756,320.0
Rory,2014,MALE,0,0,0,396,396,500.0
Rowan,2014,MALE,0,0,0,540,540,399.0
Roy,2014,MALE,828,0,0,0,828,303.0
Ruben,2014,MALE,0,0,396,0,396,500.0
Ryan,2014,MALE,18040,5060,13464,18216,54780,16.0
Ryder,2014,MALE,1080,0,0,864,1944,217.0
Salvatore,2014,MALE,0,0,0,720,720,329.0
Sam,2014,MALE,0,0,0,1152,1152,263.0
Samir,2014,MALE,0,0,0,468,468,438.0
Samuel,2014,MALE,2904,2640,10296,22660,38500,27.0
Santiago,2014,MALE,0,0,2124,0,2124,208.0
Santino,2014,MALE,0,0,0,504,504,416.0
Saul,2014,MALE,0,0,576,0,576,371.0
Savion,2014,MALE,0,360,0,0,360,538.0
Sawyer,2014,MALE,0,0,0,972,972,281.0
Sean,2014,MALE,1728,1872,1440,7632,12672,85.0
Sebastian,2014,MALE,1955,2898,33258,13800,51911,18.0
Sergio,2014,MALE,0,0,576,0,576,371.0
Seth,2014,MALE,0,360,0,0,360,538.0
Shalom,2014,MALE,0,0,0,504,504,416.0
Shane,2014,MALE,0,0,0,684,684,337.0
Shawn,2014,MALE,396,0,0,0,396,500.0
Shaya,2014,MALE,0,0,0,775,775,319.0
Shayan,2014,MALE,360,0,0,0,360,538.0
Shea,2014,MALE,0,0,0,468,468,438.0
Shia,2014,MALE,0,0,0,1332,1332,254.0
Shimon,2014,MALE,0,0,0,2500,2500,190.0
Shloime,2014,MALE,0,0,0,396,396,500.0
Shloimy,2014,MALE,0,0,0,576,576,371.0
Shlome,2014,MALE,0,0,0,684,684,337.0
Shlomo,2014,MALE,0,0,0,1980,1980,212.0
Shmiel,2014,MALE,0,0,0,684,684,337.0
Shmuel,2014,MALE,0,0,0,1425,1425,246.0
Sholom,2014,MALE,0,0,0,576,576,371.0
Shraga,2014,MALE,0,0,0,360,360,538.0
Shulem,2014,MALE,0,0,0,1125,1125,266.0
Silas,2014,MALE,0,0,0,396,396,500.0
Simcha,2014,MALE,0,0,0,828,828,303.0
Simon,2014,MALE,550,0,0,3234,3784,156.0
Sincere,2014,MALE,0,684,0,0,684,337.0
Skyler,2014,MALE,0,0,396,0,396,500.0
Solomon,2014,MALE,0,0,0,1836,1836,223.0
Spencer,2014,MALE,0,0,0,648,648,347.0
Stanley,2014,MALE,504,0,0,0,504,416.0
Stephen,2014,MALE,0,0,550,900,1450,242.0
Steve,2014,MALE,0,0,432,0,432,466.0
Steven,2014,MALE,2592,1440,10656,3888,18576,66.0
Syed,2014,MALE,720,0,0,0,720,329.0
Tenzin,2014,MALE,1512,0,0,0,1512,239.0
Theo,2014,MALE,0,0,0,432,432,466.0
Theodore,2014,MALE,2376,0,1188,13608,17172,68.0
Thiago,2014,MALE,0,0,1332,0,1332,254.0
Thomas,2014,MALE,2346,1518,3450,16284,23598,50.0
Timothy,2014,MALE,2736,1584,2304,3888,10512,101.0
Tony,2014,MALE,396,0,0,0,396,500.0
Travis,2014,MALE,660,660,0,0,1320,256.0
Tristan,2014,MALE,2736,7488,5040,3744,19008,64.0
Tyler,2014,MALE,3795,10626,5520,4692,24633,46.0
Tzvi,2014,MALE,0,0,0,1764,1764,229.0
Uriel,2014,MALE,0,0,275,0,275,583.0
Usher,2014,MALE,0,0,0,720,720,329.0
Victor,2014,MALE,1296,0,5616,3780,10692,99.0
Vincent,2014,MALE,4692,0,1785,4386,10863,97.0
Vincenzo,2014,MALE,0,0,0,396,396,500.0
Walter,2014,MALE,0,0,360,0,360,538.0
Wesley,2014,MALE,1296,0,0,792,2088,209.0
Weston,2014,MALE,0,0,0,396,396,500.0
William,2014,MALE,11220,2310,7788,20130,41448,23.0
Wilson,2014,MALE,396,0,0,0,396,500.0
Winston,2014,MALE,720,0,0,792,1512,239.0
Wolf,2014,MALE,0,0,0,432,432,466.0
Wyatt,2014,MALE,0,720,0,2376,3096,172.0
Xavier,2014,MALE,1440,6480,11952,3600,23472,52.0
Yaakov,2014,MALE,0,0,0,1656,1656,234.0
Yadiel,2014,MALE,0,0,540,0,540,399.0
Yahir,2014,MALE,0,0,540,0,540,399.0
Yahya,2014,MALE,0,0,0,396,396,500.0
Yakov,2014,MALE,0,0,0,1620,1620,236.0
Yandel,2014,MALE,0,0,540,0,540,399.0
Yariel,2014,MALE,0,0,432,0,432,466.0
Yaseen,2014,MALE,0,0,0,432,432,466.0
Yechiel,2014,MALE,0,0,0,1404,1404,247.0
Yehoshua,2014,MALE,0,0,0,936,936,286.0
Yehuda,2014,MALE,0,0,0,3096,3096,172.0
Yidel,2014,MALE,0,0,0,360,360,538.0
Yisrael,2014,MALE,0,0,0,504,504,416.0
Yisroel,2014,MALE,0,0,0,2988,2988,177.0
Yitzchak,2014,MALE,0,0,0,540,540,399.0
Yitzchok,2014,MALE,0,0,0,2376,2376,195.0
Yoel,2014,MALE,0,0,0,432,432,466.0
Yosef,2014,MALE,0,0,0,2900,2900,179.0
Yossi,2014,MALE,0,0,0,540,540,399.0
Yousef,2014,MALE,0,0,0,648,648,347.0
Youssef,2014,MALE,0,0,0,864,864,298.0
Yusuf,2014,MALE,0,0,0,576,576,371.0
Zachary,2014,MALE,2875,4968,3726,12420,23989,48.0
Zahir,2014,MALE,0,504,0,0,504,416.0
Zaiden,2014,MALE,0,504,0,0,504,416.0
Zain,2014,MALE,432,0,0,0,432,466.0
Zaire,2014,MALE,0,720,0,0,720,329.0
Zamir,2014,MALE,0,360,0,0,360,538.0
Zane,2014,MALE,0,360,0,0,360,538.0
Zayan,2014,MALE,648,0,0,0,648,347.0
Zayden,2014,MALE,0,936,936,0,1872,219.0
Zev,2014,MALE,0,0,0,1764,1764,229.0
Zion,2014,MALE,0,1440,0,0,1440,243.0
Aaliyah,2015,FEMALE,0,112,124,0,236,84.0
Aarya,2015,FEMALE,11,0,0,0,11,566.0
Abby,2015,FEMALE,24,0,0,0,24,308.0
Abigail,2015,FEMALE,140,136,572,452,1300,12.0
Ada,2015,FEMALE,0,0,0,15,15,422.0
Addison,2015,FEMALE,0,0,0,20,20,343.0
Adelaide,2015,FEMALE,0,0,0,15,15,422.0
Adele,2015,FEMALE,0,0,0,25,25,300.0
Adelina,2015,FEMALE,0,0,0,10,10,621.0
Adeline,2015,FEMALE,0,0,0,22,22,325.0
Adina,2015,FEMALE,0,0,0,23,23,317.0
Adriana,2015,FEMALE,0,0,102,60,162,113.0
Adrianna,2015,FEMALE,0,0,15,0,15,422.0
Ahuva,2015,FEMALE,0,0,0,11,11,566.0
Aicha,2015,FEMALE,0,12,0,0,12,520.0
Aileen,2015,FEMALE,0,0,17,0,17,388.0
Aisha,2015,FEMALE,57,87,0,51,195,102.0
Aissatou,2015,FEMALE,0,13,0,0,13,483.0
Aiza,2015,FEMALE,13,0,0,0,13,483.0
Aizah,2015,FEMALE,11,0,0,0,11,566.0
Alaia,2015,FEMALE,0,0,67,0,67,195.0
Alana,2015,FEMALE,0,32,48,0,80,174.0
Alani,2015,FEMALE,0,22,20,0,42,241.0
Alanis,2015,FEMALE,0,0,13,0,13,483.0
Alanna,2015,FEMALE,0,0,11,0,11,566.0
Alayna,2015,FEMALE,0,0,11,0,11,566.0
Aleah,2015,FEMALE,0,0,11,0,11,566.0
Aleena,2015,FEMALE,32,0,22,0,54,219.0
Alejandra,2015,FEMALE,0,0,17,0,17,388.0
Alessandra,2015,FEMALE,0,0,20,24,44,237.0
Alessia,2015,FEMALE,0,0,0,12,12,520.0
Alexa,2015,FEMALE,0,0,210,80,290,62.0
Alexandra,2015,FEMALE,39,0,72,297,408,50.0
Alexandria,2015,FEMALE,0,10,0,0,10,621.0
Alexia,2015,FEMALE,0,0,12,0,12,520.0
Alexis,2015,FEMALE,24,0,0,20,44,237.0
Alice,2015,FEMALE,99,0,54,192,345,58.0
Alicia,2015,FEMALE,0,0,15,0,15,422.0
Alina,2015,FEMALE,81,0,117,30,228,87.0
Alisa,2015,FEMALE,0,0,0,11,11,566.0
Alisha,2015,FEMALE,17,0,0,0,17,388.0
Alison,2015,FEMALE,0,0,23,0,23,317.0
Alisson,2015,FEMALE,0,0,15,0,15,422.0
Aliyah,2015,FEMALE,0,32,36,0,68,192.0
Aliza,2015,FEMALE,0,0,0,14,14,460.0
Allison,2015,FEMALE,57,0,264,48,369,54.0
Allyson,2015,FEMALE,0,0,14,0,14,460.0
Alma,2015,FEMALE,0,0,0,14,14,460.0
Alondra,2015,FEMALE,0,0,19,0,19,356.0
Alyssa,2015,FEMALE,44,108,120,104,376,53.0
Amaia,2015,FEMALE,0,0,12,0,12,520.0
Amalia,2015,FEMALE,0,0,24,28,52,224.0
Amanda,2015,FEMALE,26,0,64,0,90,163.0
Amara,2015,FEMALE,0,12,0,0,12,520.0
Amaya,2015,FEMALE,0,36,82,0,118,139.0
Ambar,2015,FEMALE,0,0,12,0,12,520.0
Amber,2015,FEMALE,48,30,87,0,165,110.0
Amelia,2015,FEMALE,192,120,260,368,940,17.0
Amia,2015,FEMALE,0,12,0,0,12,520.0
Amina,2015,FEMALE,0,50,0,74,124,136.0
Aminata,2015,FEMALE,0,29,0,0,29,279.0
Amira,2015,FEMALE,0,34,0,42,76,181.0
Amirah,2015,FEMALE,0,19,0,0,19,356.0
Amiyah,2015,FEMALE,0,26,0,0,26,296.0
Amy,2015,FEMALE,40,0,156,0,196,99.0
Ana,2015,FEMALE,0,0,72,22,94,159.0
Anabia,2015,FEMALE,10,0,0,0,10,621.0
Anahi,2015,FEMALE,0,0,12,0,12,520.0
Analia,2015,FEMALE,0,0,20,0,20,343.0
Anastasia,2015,FEMALE,0,0,20,64,84,170.0
Anaya,2015,FEMALE,132,30,42,0,204,93.0
Andrea,2015,FEMALE,0,0,48,0,48,229.0
Angel,2015,FEMALE,26,20,0,0,46,232.0
Angela,2015,FEMALE,171,0,42,30,243,78.0
Angelica,2015,FEMALE,0,0,22,0,22,325.0
Angelina,2015,FEMALE,90,0,111,81,282,66.0
Angelique,2015,FEMALE,0,0,16,0,16,404.0
Angie,2015,FEMALE,0,0,13,0,13,483.0
Anika,2015,FEMALE,15,0,0,0,15,422.0
Anisa,2015,FEMALE,20,0,0,20,40,244.0
Aniyah,2015,FEMALE,0,16,0,0,16,404.0
Anna,2015,FEMALE,84,0,42,288,414,48.0
Annabelle,2015,FEMALE,36,0,39,90,165,110.0
Annalise,2015,FEMALE,0,0,14,0,14,460.0
Anne,2015,FEMALE,0,0,0,10,10,621.0
Annie,2015,FEMALE,48,0,22,0,70,190.0
Antonella,2015,FEMALE,0,0,16,0,16,404.0
Antonia,2015,FEMALE,0,0,0,11,11,566.0
April,2015,FEMALE,0,0,18,0,18,372.0
Arden,2015,FEMALE,0,0,0,13,13,483.0
Aria,2015,FEMALE,108,132,88,136,464,44.0
Ariah,2015,FEMALE,0,13,0,0,13,483.0
Ariana,2015,FEMALE,100,88,372,160,720,22.0
Arianna,2015,FEMALE,68,136,280,132,616,27.0
Ariel,2015,FEMALE,40,112,80,52,284,64.0
Ariella,2015,FEMALE,0,33,33,96,162,113.0
Arielle,2015,FEMALE,0,66,30,36,132,131.0
Arisha,2015,FEMALE,13,0,0,0,13,483.0
Arya,2015,FEMALE,52,0,0,32,84,170.0
Ashley,2015,FEMALE,81,36,414,0,531,38.0
Ashly,2015,FEMALE,0,0,11,0,11,566.0
Atara,2015,FEMALE,0,0,0,11,11,566.0
Athena,2015,FEMALE,0,30,87,39,156,120.0
Aubree,2015,FEMALE,0,0,16,0,16,404.0
Aubrey,2015,FEMALE,0,81,132,69,282,66.0
Audrey,2015,FEMALE,78,0,54,108,240,80.0
Aurora,2015,FEMALE,0,0,52,44,96,157.0
Autumn,2015,FEMALE,0,111,60,33,204,93.0
Ava,2015,FEMALE,184,348,304,548,1384,8.0
Avery,2015,FEMALE,128,80,160,208,576,31.0
Avigail,2015,FEMALE,0,0,0,12,12,520.0
Aviva,2015,FEMALE,0,0,0,15,15,422.0
Aya,2015,FEMALE,0,0,0,11,11,566.0
Ayala,2015,FEMALE,0,0,0,11,11,566.0
Ayelet,2015,FEMALE,0,0,0,12,12,520.0
Ayesha,2015,FEMALE,23,0,0,0,23,317.0
Ayla,2015,FEMALE,0,0,0,21,21,336.0
Aylin,2015,FEMALE,0,0,36,0,36,251.0
Baila,2015,FEMALE,0,0,0,59,59,213.0
Bailey,2015,FEMALE,0,0,0,12,12,520.0
Barbara,2015,FEMALE,0,0,0,14,14,460.0
Batsheva,2015,FEMALE,0,0,0,20,20,343.0
Beatrice,2015,FEMALE,0,0,0,29,29,279.0
Beatrix,2015,FEMALE,0,0,0,13,13,483.0
Bella,2015,FEMALE,144,64,212,124,544,36.0
Bethany,2015,FEMALE,0,0,10,0,10,621.0
Bianca,2015,FEMALE,0,0,28,32,60,209.0
Bintou,2015,FEMALE,0,17,0,0,17,388.0
Blake,2015,FEMALE,0,0,0,16,16,404.0
Blima,2015,FEMALE,0,0,0,21,21,336.0
Blimy,2015,FEMALE,0,0,0,24,24,308.0
Bracha,2015,FEMALE,0,0,0,29,29,279.0
Breindy,2015,FEMALE,0,0,0,10,10,621.0
Brenda,2015,FEMALE,0,0,12,0,12,520.0
Briana,2015,FEMALE,0,0,25,0,25,300.0
Brianna,2015,FEMALE,0,63,279,60,402,51.0
Brielle,2015,FEMALE,0,74,0,26,100,154.0
Brittany,2015,FEMALE,0,0,25,0,25,300.0
Brooke,2015,FEMALE,0,22,0,38,60,209.0
Brooklyn,2015,FEMALE,0,10,0,0,10,621.0
Bruchy,2015,FEMALE,0,0,0,18,18,372.0
Bryanna,2015,FEMALE,0,0,13,0,13,483.0
Cali,2015,FEMALE,0,12,0,0,12,520.0
Camila,2015,FEMALE,0,0,180,0,180,106.0
Carmen,2015,FEMALE,0,0,10,0,10,621.0
Caroline,2015,FEMALE,39,0,39,186,264,73.0
Cassidy,2015,FEMALE,0,0,0,10,10,621.0
Catalina,2015,FEMALE,0,0,15,0,15,422.0
Catherine,2015,FEMALE,72,0,39,90,201,97.0
Cecilia,2015,FEMALE,22,0,0,58,80,174.0
Celine,2015,FEMALE,28,0,0,20,48,229.0
Chana,2015,FEMALE,0,0,0,136,136,129.0
Chanel,2015,FEMALE,0,0,11,0,11,566.0
Chany,2015,FEMALE,0,0,0,35,35,256.0
Charlie,2015,FEMALE,0,0,0,13,13,483.0
Charlotte,2015,FEMALE,200,56,168,696,1120,13.0
Chava,2015,FEMALE,0,0,0,33,33,262.0
Chavy,2015,FEMALE,0,0,0,27,27,290.0
Chaya,2015,FEMALE,0,0,0,158,158,117.0
Chelsea,2015,FEMALE,0,36,66,0,102,152.0
Chloe,2015,FEMALE,476,224,288,376,1364,9.0
Christina,2015,FEMALE,76,52,52,52,232,86.0
Christine,2015,FEMALE,10,0,0,0,10,621.0
Cindy,2015,FEMALE,21,0,0,0,21,336.0
Claire,2015,FEMALE,80,0,0,74,154,121.0
Clara,2015,FEMALE,20,0,0,90,110,144.0
Clementine,2015,FEMALE,0,0,0,11,11,566.0
Colette,2015,FEMALE,0,0,0,17,17,388.0
Cora,2015,FEMALE,0,0,0,27,27,290.0
Crystal,2015,FEMALE,0,0,10,0,10,621.0
Cynthia,2015,FEMALE,17,0,0,0,17,388.0
Dahlia,2015,FEMALE,0,0,0,15,15,422.0
Daisy,2015,FEMALE,0,0,15,0,15,422.0
Dakota,2015,FEMALE,0,14,0,0,14,460.0
Dalia,2015,FEMALE,0,0,0,13,13,483.0
Daniela,2015,FEMALE,0,0,120,20,140,126.0
Daniella,2015,FEMALE,0,0,34,44,78,178.0
Danielle,2015,FEMALE,0,11,0,0,11,566.0
Danna,2015,FEMALE,0,0,27,0,27,290.0
Daphne,2015,FEMALE,0,0,20,26,46,232.0
Dayana,2015,FEMALE,0,0,19,0,19,356.0
Delilah,2015,FEMALE,0,0,56,0,56,216.0
Denisse,2015,FEMALE,0,0,11,0,11,566.0
Destiny,2015,FEMALE,0,36,30,0,66,196.0
Devora,2015,FEMALE,0,0,0,21,21,336.0
Devorah,2015,FEMALE,0,0,0,33,33,262.0
Diana,2015,FEMALE,33,0,114,48,195,102.0
Dina,2015,FEMALE,0,0,0,40,40,244.0
Dylan,2015,FEMALE,0,0,0,28,28,285.0
Eden,2015,FEMALE,0,20,0,34,54,219.0
Edith,2015,FEMALE,0,0,0,18,18,372.0
Egypt,2015,FEMALE,0,15,0,0,15,422.0
Eileen,2015,FEMALE,26,0,36,0,62,205.0
Elaine,2015,FEMALE,12,0,0,0,12,520.0
Eleanor,2015,FEMALE,22,0,0,182,204,93.0
Elena,2015,FEMALE,81,0,81,51,213,90.0
Eliana,2015,FEMALE,36,0,117,120,273,70.0
Elianny,2015,FEMALE,0,0,11,0,11,566.0
Elina,2015,FEMALE,15,0,0,0,15,422.0
Elisa,2015,FEMALE,0,0,13,0,13,483.0
Elise,2015,FEMALE,22,0,0,50,72,187.0
Elisheva,2015,FEMALE,0,0,0,15,15,422.0
Eliza,2015,FEMALE,0,0,0,26,26,296.0
Elizabeth,2015,FEMALE,96,104,296,384,880,18.0
Ella,2015,FEMALE,105,0,78,378,561,34.0
Elle,2015,FEMALE,0,0,0,26,26,296.0
Ellie,2015,FEMALE,75,0,36,78,189,104.0
Elodie,2015,FEMALE,0,0,0,10,10,621.0
Eloise,2015,FEMALE,0,0,0,24,24,308.0
Elsa,2015,FEMALE,15,0,0,0,15,422.0
Emaan,2015,FEMALE,11,0,0,0,11,566.0
Emely,2015,FEMALE,0,0,56,0,56,216.0
Emerson,2015,FEMALE,0,0,0,18,18,372.0
Emilia,2015,FEMALE,45,0,51,144,240,80.0
Emily,2015,FEMALE,396,124,548,512,1580,7.0
Emma,2015,FEMALE,296,68,784,900,2048,3.0
Erica,2015,FEMALE,11,0,0,0,11,566.0
Erika,2015,FEMALE,0,0,13,0,13,483.0
Erin,2015,FEMALE,0,11,0,0,11,566.0
Esme,2015,FEMALE,0,0,0,10,10,621.0
Esmeralda,2015,FEMALE,0,0,12,0,12,520.0
Esther,2015,FEMALE,0,54,60,618,732,21.0
Esty,2015,FEMALE,0,0,0,35,35,256.0
Etty,2015,FEMALE,0,0,0,19,19,356.0
Eva,2015,FEMALE,72,68,172,264,576,31.0
Evangeline,2015,FEMALE,0,0,0,16,16,404.0
Eve,2015,FEMALE,0,0,0,17,17,388.0
Evelina,2015,FEMALE,0,0,0,10,10,621.0
Evelyn,2015,FEMALE,108,0,114,165,387,52.0
Everly,2015,FEMALE,0,0,0,14,14,460.0
Evie,2015,FEMALE,0,0,0,10,10,621.0
Faiga,2015,FEMALE,0,0,0,17,17,388.0
Faigy,2015,FEMALE,0,0,0,68,68,192.0
Faith,2015,FEMALE,0,72,34,0,106,151.0
Fatima,2015,FEMALE,105,87,0,33,225,88.0
Fatou,2015,FEMALE,0,11,0,0,11,566.0
Fatoumata,2015,FEMALE,0,28,0,0,28,285.0
Fiona,2015,FEMALE,56,0,0,62,118,139.0
Fradel,2015,FEMALE,0,0,0,16,16,404.0
Frady,2015,FEMALE,0,0,0,14,14,460.0
Fraidy,2015,FEMALE,0,0,0,24,24,308.0
Frances,2015,FEMALE,0,0,0,28,28,285.0
Francesca,2015,FEMALE,0,0,0,31,31,271.0
Freya,2015,FEMALE,0,0,0,14,14,460.0
Frieda,2015,FEMALE,0,0,0,10,10,621.0
Frimet,2015,FEMALE,0,0,0,13,13,483.0
Gabriela,2015,FEMALE,0,0,108,32,140,126.0
Gabriella,2015,FEMALE,0,108,183,192,483,41.0
Gabrielle,2015,FEMALE,0,60,0,28,88,166.0
Gemma,2015,FEMALE,0,0,0,20,20,343.0
Genesis,2015,FEMALE,0,32,170,0,202,96.0
Genevieve,2015,FEMALE,0,0,0,24,24,308.0
Georgia,2015,FEMALE,0,0,0,22,22,325.0
Gia,2015,FEMALE,0,0,0,14,14,460.0
Gianna,2015,FEMALE,0,45,90,135,270,72.0
Giselle,2015,FEMALE,33,0,57,33,123,137.0
Gittel,2015,FEMALE,0,0,0,14,14,460.0
Gitty,2015,FEMALE,0,0,0,75,75,184.0
Giulia,2015,FEMALE,0,0,0,11,11,566.0
Giuliana,2015,FEMALE,0,0,0,27,27,290.0
Golda,2015,FEMALE,0,0,0,13,13,483.0
Goldie,2015,FEMALE,0,0,0,13,13,483.0
Goldy,2015,FEMALE,0,0,0,32,32,265.0
Grace,2015,FEMALE,260,88,168,364,880,18.0
Greta,2015,FEMALE,0,0,0,11,11,566.0
Guadalupe,2015,FEMALE,0,0,18,0,18,372.0
Hadley,2015,FEMALE,0,0,0,11,11,566.0
Hafsa,2015,FEMALE,11,0,0,0,11,566.0
Hailey,2015,FEMALE,120,104,336,124,684,23.0
Hana,2015,FEMALE,0,0,0,20,20,343.0
Haniya,2015,FEMALE,11,0,0,0,11,566.0
Hanna,2015,FEMALE,34,0,0,32,66,196.0
Hannah,2015,FEMALE,156,56,104,268,584,29.0
Harmony,2015,FEMALE,0,20,0,0,20,343.0
Harper,2015,FEMALE,30,0,0,112,142,125.0
Hawa,2015,FEMALE,0,15,0,0,15,422.0
Hazel,2015,FEMALE,0,0,26,82,108,147.0
Heaven,2015,FEMALE,0,38,20,0,58,214.0
Heidy,2015,FEMALE,0,0,11,0,11,566.0
Helen,2015,FEMALE,0,0,30,20,50,227.0
Helena,2015,FEMALE,0,0,0,10,10,621.0
Henny,2015,FEMALE,0,0,0,30,30,274.0
Hinda,2015,FEMALE,0,0,0,24,24,308.0
Hindy,2015,FEMALE,0,0,0,25,25,300.0
Idy,2015,FEMALE,0,0,0,12,12,520.0
Imani,2015,FEMALE,0,16,0,0,16,404.0
Inaaya,2015,FEMALE,12,0,0,0,12,520.0
Irene,2015,FEMALE,16,0,0,0,16,404.0
Iris,2015,FEMALE,22,0,0,0,22,325.0
Isabel,2015,FEMALE,30,0,135,123,288,63.0
Isabela,2015,FEMALE,0,0,10,0,10,621.0
Isabella,2015,FEMALE,252,92,1228,412,1984,5.0
Isabelle,2015,FEMALE,60,108,72,128,368,55.0
Isla,2015,FEMALE,20,0,0,88,108,147.0
Itzel,2015,FEMALE,0,0,13,0,13,483.0
Ivy,2015,FEMALE,38,0,0,38,76,181.0
Izabella,2015,FEMALE,0,0,11,0,11,566.0
Jacqueline,2015,FEMALE,30,0,51,39,120,138.0
Jada,2015,FEMALE,0,23,0,0,23,317.0
Jade,2015,FEMALE,0,40,96,0,136,129.0
Jaelyn,2015,FEMALE,0,0,11,0,11,566.0
Jane,2015,FEMALE,0,0,0,18,18,372.0
Janelle,2015,FEMALE,0,0,10,0,10,621.0
Janice,2015,FEMALE,13,0,0,0,13,483.0
Janiya,2015,FEMALE,0,10,0,0,10,621.0
Janiyah,2015,FEMALE,0,17,0,0,17,388.0
Jannat,2015,FEMALE,14,0,0,0,14,460.0
Jannatul,2015,FEMALE,11,0,0,0,11,566.0
Jasmine,2015,FEMALE,102,54,84,0,240,80.0
Jayda,2015,FEMALE,0,10,0,0,10,621.0
Jayla,2015,FEMALE,0,36,42,0,78,178.0
Jaylee,2015,FEMALE,0,0,15,0,15,422.0
Jayleen,2015,FEMALE,0,0,34,0,34,259.0
Jaylene,2015,FEMALE,0,0,22,0,22,325.0
Jaylin,2015,FEMALE,0,0,15,0,15,422.0
Jazlyn,2015,FEMALE,0,0,16,0,16,404.0
Jazmin,2015,FEMALE,0,0,31,0,31,271.0
Jazmine,2015,FEMALE,0,0,10,0,10,621.0
Jenna,2015,FEMALE,0,0,0,18,18,372.0
Jennifer,2015,FEMALE,24,0,48,0,72,187.0
Jenny,2015,FEMALE,18,0,0,0,18,372.0
Jessica,2015,FEMALE,108,0,57,33,198,98.0
Jessie,2015,FEMALE,12,0,0,0,12,520.0
Jimena,2015,FEMALE,0,0,13,0,13,483.0
Joanna,2015,FEMALE,29,0,0,0,29,279.0
Jocelyn,2015,FEMALE,26,0,36,0,62,205.0
Jordan,2015,FEMALE,0,10,0,0,10,621.0
Jordyn,2015,FEMALE,0,19,0,0,19,356.0
Joselyn,2015,FEMALE,0,0,12,0,12,520.0
Josephine,2015,FEMALE,30,0,33,144,207,91.0
Journey,2015,FEMALE,0,17,0,0,17,388.0
Joy,2015,FEMALE,24,20,0,0,44,237.0
Joyce,2015,FEMALE,24,0,0,20,44,237.0
Judy,2015,FEMALE,0,0,0,12,12,520.0
Julia,2015,FEMALE,68,40,76,280,464,44.0
Juliana,2015,FEMALE,0,0,44,52,96,157.0
Julianna,2015,FEMALE,0,0,40,50,90,163.0
Julie,2015,FEMALE,0,0,0,10,10,621.0
Juliet,2015,FEMALE,0,0,56,70,126,135.0
Juliette,2015,FEMALE,0,0,86,72,158,117.0
Julissa,2015,FEMALE,0,0,16,0,16,404.0
June,2015,FEMALE,0,0,0,19,19,356.0
Juniper,2015,FEMALE,0,0,0,15,15,422.0
Kadiatou,2015,FEMALE,0,12,0,0,12,520.0
Kaia,2015,FEMALE,0,0,0,12,12,520.0
Kailee,2015,FEMALE,0,11,0,0,11,566.0
Kailey,2015,FEMALE,0,0,11,0,11,566.0
Kaitlyn,2015,FEMALE,60,33,87,0,180,106.0
Kali,2015,FEMALE,0,23,0,0,23,317.0
Kaliyah,2015,FEMALE,0,12,0,0,12,520.0
Kamila,2015,FEMALE,0,0,22,0,22,325.0
Karen,2015,FEMALE,20,0,46,0,66,196.0
Karina,2015,FEMALE,11,0,0,0,11,566.0
Karla,2015,FEMALE,0,0,17,0,17,388.0
Kate,2015,FEMALE,0,0,24,40,64,203.0
Katelyn,2015,FEMALE,0,0,13,0,13,483.0
Katerina,2015,FEMALE,0,0,0,13,13,483.0
Katherine,2015,FEMALE,54,0,144,150,348,57.0
Katie,2015,FEMALE,12,0,0,0,12,520.0
Kayla,2015,FEMALE,140,176,148,140,604,28.0
Kaylee,2015,FEMALE,78,66,207,0,351,56.0
Kayleen,2015,FEMALE,0,0,11,0,11,566.0
Kaylie,2015,FEMALE,0,0,13,0,13,483.0
Keily,2015,FEMALE,0,0,14,0,14,460.0
Keira,2015,FEMALE,0,0,0,20,20,343.0
Kelly,2015,FEMALE,34,0,34,0,68,192.0
Kelsey,2015,FEMALE,0,12,0,0,12,520.0
Kennedy,2015,FEMALE,0,56,0,20,76,181.0
Keyla,2015,FEMALE,0,0,15,0,15,422.0
Khloe,2015,FEMALE,30,96,111,0,237,83.0
Kiara,2015,FEMALE,0,0,32,0,32,265.0
Kiera,2015,FEMALE,0,0,0,13,13,483.0
Kimberly,2015,FEMALE,0,0,88,0,88,166.0
Kimora,2015,FEMALE,0,16,0,0,16,404.0
Kira,2015,FEMALE,24,0,0,28,52,224.0
Kristina,2015,FEMALE,0,0,0,10,10,621.0
Kyla,2015,FEMALE,0,18,0,0,18,372.0
Kylie,2015,FEMALE,0,104,132,0,236,84.0
Laila,2015,FEMALE,0,75,51,48,174,109.0
Lana,2015,FEMALE,0,0,0,12,12,520.0
Lara,2015,FEMALE,0,0,0,18,18,372.0
Laura,2015,FEMALE,0,0,0,16,16,404.0
Lauren,2015,FEMALE,48,96,64,76,284,64.0
Lauryn,2015,FEMALE,0,11,0,0,11,566.0
Layla,2015,FEMALE,40,136,200,204,580,30.0
Lea,2015,FEMALE,0,0,0,20,20,343.0
Leah,2015,FEMALE,136,188,408,880,1612,6.0
Leela,2015,FEMALE,14,0,0,0,14,460.0
Leia,2015,FEMALE,0,0,10,0,10,621.0
Leila,2015,FEMALE,0,39,57,69,165,110.0
Leilani,2015,FEMALE,0,50,62,0,112,143.0
Lena,2015,FEMALE,24,0,0,38,62,205.0
Leslie,2015,FEMALE,0,0,32,0,32,265.0
Leyla,2015,FEMALE,0,0,0,18,18,372.0
Lia,2015,FEMALE,0,0,56,52,108,147.0
Liana,2015,FEMALE,0,0,20,26,46,232.0
Liba,2015,FEMALE,0,0,0,30,30,274.0
Libby,2015,FEMALE,0,0,0,24,24,308.0
Lila,2015,FEMALE,0,0,0,37,37,250.0
Lilah,2015,FEMALE,0,0,0,11,11,566.0
Lilia,2015,FEMALE,0,0,0,11,11,566.0
Liliana,2015,FEMALE,0,0,44,56,100,154.0
Lillian,2015,FEMALE,38,0,0,60,98,156.0
Lilly,2015,FEMALE,0,0,0,12,12,520.0
Lily,2015,FEMALE,88,40,76,336,540,37.0
Lina,2015,FEMALE,0,0,0,13,13,483.0
Lindsay,2015,FEMALE,0,0,10,0,10,621.0
Lisa,2015,FEMALE,10,0,0,0,10,621.0
Liv,2015,FEMALE,0,0,0,18,18,372.0
Livia,2015,FEMALE,0,0,0,13,13,483.0
Lizbeth,2015,FEMALE,0,0,23,0,23,317.0
Lizeth,2015,FEMALE,0,0,10,0,10,621.0
Logan,2015,FEMALE,0,0,0,11,11,566.0
Lola,2015,FEMALE,0,0,20,46,66,196.0
London,2015,FEMALE,0,153,60,30,243,78.0
Londyn,2015,FEMALE,0,40,20,0,60,209.0
Louisa,2015,FEMALE,0,0,0,16,16,404.0
Louise,2015,FEMALE,0,0,0,14,14,460.0
Lucia,2015,FEMALE,0,0,60,68,128,132.0
Luciana,2015,FEMALE,0,0,19,0,19,356.0
Lucy,2015,FEMALE,26,0,0,92,118,139.0
Luna,2015,FEMALE,36,0,141,84,261,74.0
Lydia,2015,FEMALE,12,0,0,0,12,520.0
Lyla,2015,FEMALE,0,0,0,24,24,308.0
Lyric,2015,FEMALE,0,18,0,0,18,372.0
Mackenzie,2015,FEMALE,0,36,48,75,159,116.0
Madeleine,2015,FEMALE,0,0,0,27,27,290.0
Madeline,2015,FEMALE,36,0,39,174,249,75.0
Madelyn,2015,FEMALE,0,0,52,26,78,178.0
Madison,2015,FEMALE,100,512,480,268,1360,10.0
Mae,2015,FEMALE,0,0,0,15,15,422.0
Maeve,2015,FEMALE,0,0,0,15,15,422.0
Mahnoor,2015,FEMALE,10,0,0,0,10,621.0
Maia,2015,FEMALE,0,0,50,30,80,174.0
Maisie,2015,FEMALE,0,0,0,10,10,621.0
Makayla,2015,FEMALE,0,68,24,0,92,162.0
Malak,2015,FEMALE,0,0,0,15,15,422.0
Malaysia,2015,FEMALE,0,17,0,0,17,388.0
Malia,2015,FEMALE,0,22,0,0,22,325.0
Maliha,2015,FEMALE,11,0,0,0,11,566.0
Malika,2015,FEMALE,0,0,0,10,10,621.0
Maliyah,2015,FEMALE,0,18,0,0,18,372.0
Malka,2015,FEMALE,0,0,0,74,74,185.0
Malky,2015,FEMALE,0,0,0,65,65,202.0
Manha,2015,FEMALE,20,0,0,0,20,343.0
Margaret,2015,FEMALE,0,0,0,41,41,243.0
Margaux,2015,FEMALE,0,0,0,14,14,460.0
Margot,2015,FEMALE,0,0,0,21,21,336.0
Maria,2015,FEMALE,0,0,88,108,196,99.0
Mariah,2015,FEMALE,0,36,36,0,72,187.0
Mariam,2015,FEMALE,42,87,0,60,189,104.0
Mariama,2015,FEMALE,0,18,0,0,18,372.0
Mariana,2015,FEMALE,0,0,15,0,15,422.0
Marjorie,2015,FEMALE,0,0,11,0,11,566.0
Marley,2015,FEMALE,0,12,0,0,12,520.0
Marlowe,2015,FEMALE,0,0,0,10,10,621.0
Mary,2015,FEMALE,0,0,0,23,23,317.0
Maryam,2015,FEMALE,38,0,0,32,70,190.0
Matilda,2015,FEMALE,0,0,0,21,21,336.0
Maya,2015,FEMALE,116,92,184,432,824,20.0
McKenzie,2015,FEMALE,0,22,0,0,22,325.0
Megan,2015,FEMALE,20,0,20,0,40,244.0
Melanie,2015,FEMALE,0,28,168,0,196,99.0
Melany,2015,FEMALE,0,0,34,0,34,259.0
Melina,2015,FEMALE,0,0,12,0,12,520.0
Melissa,2015,FEMALE,0,0,48,26,74,185.0
Melody,2015,FEMALE,42,0,40,0,82,172.0
Mia,2015,FEMALE,236,244,1028,516,2024,4.0
Michaela,2015,FEMALE,0,0,0,11,11,566.0
Michelle,2015,FEMALE,84,76,168,100,428,47.0
Mika,2015,FEMALE,0,0,0,11,11,566.0
Mikaela,2015,FEMALE,0,0,15,0,15,422.0
Mikayla,2015,FEMALE,0,30,24,0,54,219.0
Mila,2015,FEMALE,72,40,188,204,504,40.0
Milan,2015,FEMALE,0,19,0,0,19,356.0
Milana,2015,FEMALE,0,0,0,25,25,300.0
Milani,2015,FEMALE,0,24,22,0,46,232.0
Milena,2015,FEMALE,0,0,0,19,19,356.0
Mindy,2015,FEMALE,0,0,0,14,14,460.0
Mira,2015,FEMALE,22,0,0,20,42,241.0
Miracle,2015,FEMALE,0,15,0,0,15,422.0
Miranda,2015,FEMALE,0,0,19,0,19,356.0
Mirel,2015,FEMALE,0,0,0,12,12,520.0
Miri,2015,FEMALE,0,0,0,17,17,388.0
Miriam,2015,FEMALE,0,0,0,177,177,108.0
Molly,2015,FEMALE,0,0,0,47,47,231.0
Montserrat,2015,FEMALE,0,0,12,0,12,520.0
Morgan,2015,FEMALE,0,58,0,30,88,166.0
Mya,2015,FEMALE,0,36,58,0,94,159.0
Nabiha,2015,FEMALE,14,0,0,0,14,460.0
Nadia,2015,FEMALE,0,0,0,14,14,460.0
Nala,2015,FEMALE,0,12,0,0,12,520.0
Naomi,2015,FEMALE,80,108,120,148,456,46.0
Nashla,2015,FEMALE,0,0,14,0,14,460.0
Natalia,2015,FEMALE,0,0,46,36,82,172.0
Natalie,2015,FEMALE,60,0,90,126,276,68.0
Nathalia,2015,FEMALE,0,0,13,0,13,483.0
Nathalie,2015,FEMALE,0,0,15,0,15,422.0
Nathaly,2015,FEMALE,0,0,19,0,19,356.0
Nechama,2015,FEMALE,0,0,0,36,36,251.0
Nevaeh,2015,FEMALE,0,29,0,0,29,279.0
Nia,2015,FEMALE,0,29,0,0,29,279.0
Nicole,2015,FEMALE,57,0,156,108,321,60.0
Nicolette,2015,FEMALE,0,0,0,12,12,520.0
Nina,2015,FEMALE,32,0,0,70,102,152.0
Noa,2015,FEMALE,0,0,0,36,36,251.0
Noelle,2015,FEMALE,0,0,0,13,13,483.0
Noemi,2015,FEMALE,0,0,12,0,12,520.0
Noor,2015,FEMALE,20,0,0,26,46,232.0
Nora,2015,FEMALE,0,0,0,53,53,223.0
Norah,2015,FEMALE,0,0,0,16,16,404.0
Nova,2015,FEMALE,0,15,0,0,15,422.0
Nyla,2015,FEMALE,0,38,0,0,38,249.0
Nylah,2015,FEMALE,0,50,44,0,94,159.0
Olive,2015,FEMALE,0,0,0,15,15,422.0
Olivia,2015,FEMALE,752,328,376,900,2356,1.0
Oumou,2015,FEMALE,0,11,0,0,11,566.0
Paige,2015,FEMALE,0,48,0,42,90,163.0
Paris,2015,FEMALE,0,16,0,0,16,404.0
Pearl,2015,FEMALE,0,0,0,26,26,296.0
Penelope,2015,FEMALE,60,0,156,198,414,48.0
Perel,2015,FEMALE,0,0,0,11,11,566.0
Perl,2015,FEMALE,0,0,0,12,12,520.0
Perla,2015,FEMALE,0,0,15,0,15,422.0
Perry,2015,FEMALE,0,0,0,13,13,483.0
Pessy,2015,FEMALE,0,0,0,33,33,262.0
Peyton,2015,FEMALE,0,132,36,39,207,91.0
Phoebe,2015,FEMALE,40,0,0,40,80,174.0
Poppy,2015,FEMALE,0,0,0,10,10,621.0
Priscilla,2015,FEMALE,20,0,20,0,40,244.0
Queena,2015,FEMALE,13,0,0,0,13,483.0
Queenie,2015,FEMALE,19,0,0,0,19,356.0
Quinn,2015,FEMALE,0,0,0,30,30,274.0
Rachel,2015,FEMALE,102,0,30,537,669,24.0
Raina,2015,FEMALE,11,0,0,0,11,566.0
Raizel,2015,FEMALE,0,0,0,25,25,300.0
Raizy,2015,FEMALE,0,0,0,57,57,215.0
Raquel,2015,FEMALE,0,0,0,15,15,422.0
Rebecca,2015,FEMALE,51,0,39,132,222,89.0
Reese,2015,FEMALE,0,0,0,22,22,325.0
Rifky,2015,FEMALE,0,0,0,14,14,460.0
Riley,2015,FEMALE,40,200,144,184,568,33.0
Rina,2015,FEMALE,0,0,0,12,12,520.0
Rivka,2015,FEMALE,0,0,0,127,127,134.0
Rivkah,2015,FEMALE,0,0,0,13,13,483.0
Rivky,2015,FEMALE,0,0,0,55,55,218.0
Rochel,2015,FEMALE,0,0,0,27,27,290.0
Rosa,2015,FEMALE,0,0,15,0,15,422.0
Rose,2015,FEMALE,0,0,30,108,138,128.0
Royal,2015,FEMALE,0,10,0,0,10,621.0
Ruby,2015,FEMALE,39,0,36,174,249,75.0
Ruchy,2015,FEMALE,0,0,0,20,20,343.0
Ruth,2015,FEMALE,0,0,0,12,12,520.0
Ryan,2015,FEMALE,0,0,0,13,13,483.0
Sabina,2015,FEMALE,0,0,0,12,12,520.0
Sabrina,2015,FEMALE,48,0,33,72,153,122.0
Sadie,2015,FEMALE,0,0,0,32,32,265.0
Saige,2015,FEMALE,0,10,0,0,10,621.0
Salma,2015,FEMALE,0,0,0,10,10,621.0
Samaira,2015,FEMALE,13,0,0,0,13,483.0
Samantha,2015,FEMALE,40,44,360,200,644,25.0
Samara,2015,FEMALE,0,15,0,0,15,422.0
Samira,2015,FEMALE,0,0,0,17,17,388.0
Samiyah,2015,FEMALE,0,11,0,0,11,566.0
Sanaa,2015,FEMALE,0,12,0,0,12,520.0
Sanai,2015,FEMALE,0,14,0,0,14,460.0
Sara,2015,FEMALE,60,0,69,381,510,39.0
Sarah,2015,FEMALE,148,120,256,832,1356,11.0
Sarahi,2015,FEMALE,0,0,16,0,16,404.0
Sarai,2015,FEMALE,0,52,58,0,110,144.0
Sari,2015,FEMALE,0,0,0,10,10,621.0
Sariah,2015,FEMALE,0,11,0,0,11,566.0
Sariyah,2015,FEMALE,0,10,0,0,10,621.0
Sasha,2015,FEMALE,0,0,20,32,52,224.0
Savannah,2015,FEMALE,48,212,220,72,552,35.0
Scarlet,2015,FEMALE,0,0,15,0,15,422.0
Scarlett,2015,FEMALE,30,0,285,159,474,43.0
Selena,2015,FEMALE,0,0,19,0,19,356.0
Selina,2015,FEMALE,18,0,0,0,18,372.0
Serena,2015,FEMALE,22,0,0,0,22,325.0
Serenity,2015,FEMALE,0,94,64,0,158,117.0
Shaina,2015,FEMALE,0,0,0,14,14,460.0
Shaindel,2015,FEMALE,0,0,0,10,10,621.0
Shaindy,2015,FEMALE,0,0,0,35,35,256.0
Sherlyn,2015,FEMALE,0,0,16,0,16,404.0
Shifra,2015,FEMALE,0,0,0,13,13,483.0
Shiloh,2015,FEMALE,0,10,0,0,10,621.0
Shira,2015,FEMALE,0,0,0,19,19,356.0
Shirley,2015,FEMALE,32,0,30,0,62,205.0
Shoshana,2015,FEMALE,0,0,0,13,13,483.0
Siena,2015,FEMALE,0,0,0,20,20,343.0
Sienna,2015,FEMALE,36,0,36,177,249,75.0
Sima,2015,FEMALE,0,0,0,20,20,343.0
Simone,2015,FEMALE,0,0,0,17,17,388.0
Sky,2015,FEMALE,0,10,0,0,10,621.0
Skye,2015,FEMALE,0,15,0,0,15,422.0
Skyla,2015,FEMALE,0,36,30,0,66,196.0
Skylar,2015,FEMALE,40,364,152,72,628,26.0
Skyler,2015,FEMALE,0,15,0,0,15,422.0
Sloane,2015,FEMALE,0,0,0,32,32,265.0
Sofia,2015,FEMALE,75,0,534,357,966,16.0
Sophia,2015,FEMALE,416,108,1076,500,2100,2.0
Sophie,2015,FEMALE,84,0,72,174,330,59.0
Stacy,2015,FEMALE,0,0,15,0,15,422.0
Stella,2015,FEMALE,78,0,39,198,315,61.0
Stephanie,2015,FEMALE,44,0,66,0,110,144.0
Summer,2015,FEMALE,0,45,36,33,114,142.0
Suri,2015,FEMALE,0,0,0,12,12,520.0
Sury,2015,FEMALE,0,0,0,36,36,251.0
Sydney,2015,FEMALE,0,42,0,66,108,147.0
Sylvia,2015,FEMALE,22,0,0,38,60,209.0
Sylvie,2015,FEMALE,0,0,0,15,15,422.0
Talia,2015,FEMALE,0,0,0,54,54,219.0
Taliyah,2015,FEMALE,0,11,0,0,11,566.0
Tanisha,2015,FEMALE,12,0,0,0,12,520.0
Taylor,2015,FEMALE,0,112,0,36,148,124.0
Tehila,2015,FEMALE,0,0,0,11,11,566.0
Tenzin,2015,FEMALE,25,0,0,0,25,300.0
Tessa,2015,FEMALE,0,0,0,19,19,356.0
Thea,2015,FEMALE,0,0,0,15,15,422.0
Tiana,2015,FEMALE,0,10,0,0,10,621.0
Tiffany,2015,FEMALE,44,0,22,0,66,196.0
Tina,2015,FEMALE,10,0,0,0,10,621.0
Toby,2015,FEMALE,0,0,0,50,50,227.0
Tori,2015,FEMALE,0,17,0,0,17,388.0
Tova,2015,FEMALE,0,0,0,10,10,621.0
Trinity,2015,FEMALE,0,21,0,0,21,336.0
Tziporah,2015,FEMALE,0,0,0,11,11,566.0
Valentina,2015,FEMALE,0,0,198,78,276,68.0
Valeria,2015,FEMALE,0,0,36,0,36,251.0
Valerie,2015,FEMALE,0,0,104,24,128,132.0
Valery,2015,FEMALE,0,0,13,0,13,483.0
Vanessa,2015,FEMALE,0,0,62,26,88,166.0
Vera,2015,FEMALE,0,0,0,28,28,285.0
Veronica,2015,FEMALE,0,0,0,12,12,520.0
Vicky,2015,FEMALE,20,0,0,0,20,343.0
Victoria,2015,FEMALE,112,116,472,296,996,15.0
Violet,2015,FEMALE,0,0,52,100,152,123.0
Violeta,2015,FEMALE,0,0,10,0,10,621.0
Vivian,2015,FEMALE,62,0,0,98,160,115.0
Vivienne,2015,FEMALE,0,0,0,31,31,271.0
Wendy,2015,FEMALE,0,0,11,0,11,566.0
Willa,2015,FEMALE,0,0,0,30,30,274.0
Willow,2015,FEMALE,0,0,0,11,11,566.0
Winnie,2015,FEMALE,13,0,0,0,13,483.0
Wynter,2015,FEMALE,0,12,0,0,12,520.0
Ximena,2015,FEMALE,0,0,23,0,23,317.0
Yachet,2015,FEMALE,0,0,0,12,12,520.0
Yael,2015,FEMALE,0,0,0,19,19,356.0
Yaretzi,2015,FEMALE,0,0,25,0,25,300.0
Yaritza,2015,FEMALE,0,0,12,0,12,520.0
Yasmina,2015,FEMALE,0,0,0,11,11,566.0
Yehudis,2015,FEMALE,0,0,0,24,24,308.0
Yides,2015,FEMALE,0,0,0,34,34,259.0
Yitty,2015,FEMALE,0,0,0,40,40,244.0
Yocheved,2015,FEMALE,0,0,0,28,28,285.0
Zahara,2015,FEMALE,0,11,0,0,11,566.0
Zahra,2015,FEMALE,40,24,0,0,64,203.0
Zainab,2015,FEMALE,22,0,0,0,22,325.0
Zara,2015,FEMALE,88,80,48,56,272,71.0
Zariah,2015,FEMALE,0,11,0,0,11,566.0
Zendaya,2015,FEMALE,0,13,0,0,13,483.0
Zissy,2015,FEMALE,0,0,0,30,30,274.0
Zoe,2015,FEMALE,144,152,320,444,1060,14.0
Zoey,2015,FEMALE,60,136,196,84,476,42.0
Zuri,2015,FEMALE,0,32,0,0,32,265.0
Aahil,2015,MALE,13,0,0,0,13,450.0
Aarav,2015,MALE,15,0,0,0,15,402.0
Aaron,2015,MALE,228,228,504,292,1252,26.0
Aaryan,2015,MALE,10,0,0,0,10,547.0
Aayan,2015,MALE,14,0,0,0,14,424.0
Abdiel,2015,MALE,0,0,16,0,16,389.0
Abdoul,2015,MALE,0,10,0,0,10,547.0
Abdoulaye,2015,MALE,0,13,0,0,13,450.0
Abdul,2015,MALE,11,0,0,0,11,513.0
Abdullah,2015,MALE,28,0,0,0,28,284.0
Abel,2015,MALE,0,0,21,0,21,332.0
Aboubacar,2015,MALE,0,13,0,0,13,450.0
Abraham,2015,MALE,0,0,72,290,362,88.0
Abrar,2015,MALE,10,0,0,0,10,547.0
Adam,2015,MALE,168,104,172,604,1048,31.0
Aden,2015,MALE,0,19,0,0,19,346.0
Adonis,2015,MALE,0,12,0,0,12,479.0
Adrian,2015,MALE,88,64,584,192,928,36.0
Adriel,2015,MALE,0,0,37,0,37,256.0
Aharon,2015,MALE,0,0,0,15,15,402.0
Ahmad,2015,MALE,15,0,0,0,15,402.0
Ahmed,2015,MALE,66,33,0,84,183,121.0
Ahron,2015,MALE,0,0,0,11,11,513.0
Aidan,2015,MALE,51,0,54,105,210,114.0
Aiden,2015,MALE,532,492,748,312,2084,10.0
Akiva,2015,MALE,0,0,0,15,15,402.0
Alan,2015,MALE,84,0,204,72,360,89.0
Albert,2015,MALE,0,0,52,36,88,173.0
Alberto,2015,MALE,0,0,10,0,10,547.0
Alejandro,2015,MALE,0,0,50,0,50,231.0
Alessandro,2015,MALE,0,0,0,11,11,513.0
Alex,2015,MALE,126,0,144,69,339,91.0
Alexander,2015,MALE,252,184,708,800,1944,12.0
Alexis,2015,MALE,0,0,37,0,37,256.0
Ali,2015,MALE,39,30,0,141,210,114.0
Allan,2015,MALE,0,0,14,0,14,424.0
Allen,2015,MALE,40,0,42,0,82,179.0
Alonso,2015,MALE,0,0,10,0,10,547.0
Alpha,2015,MALE,0,13,0,0,13,450.0
Alston,2015,MALE,10,0,0,0,10,547.0
Alvin,2015,MALE,56,0,40,0,96,164.0
Amadou,2015,MALE,0,18,0,0,18,359.0
Amari,2015,MALE,0,88,26,0,114,154.0
Amir,2015,MALE,0,237,120,105,462,70.0
Anderson,2015,MALE,26,0,42,0,68,203.0
Andre,2015,MALE,0,15,0,0,15,402.0
Andres,2015,MALE,0,0,32,0,32,268.0
Andrew,2015,MALE,192,120,384,392,1088,30.0
Andy,2015,MALE,76,0,68,0,144,140.0
Angel,2015,MALE,0,42,388,0,430,76.0
Angelo,2015,MALE,0,0,30,30,60,213.0
Anson,2015,MALE,26,0,0,0,26,296.0
Anthony,2015,MALE,108,172,628,412,1320,22.0
Anton,2015,MALE,0,0,0,10,10,547.0
Antonio,2015,MALE,0,0,64,62,126,148.0
Archer,2015,MALE,0,0,0,14,14,424.0
Arham,2015,MALE,21,0,0,0,21,332.0
Ari,2015,MALE,0,0,0,50,50,231.0
Ariel,2015,MALE,0,0,40,46,86,176.0
Arjun,2015,MALE,12,0,0,0,12,479.0
Arlo,2015,MALE,0,0,0,11,11,513.0
Armaan,2015,MALE,13,0,0,0,13,450.0
Armando,2015,MALE,0,0,10,0,10,547.0
Armani,2015,MALE,0,0,15,0,15,402.0
Aron,2015,MALE,0,0,0,74,74,197.0
Arthur,2015,MALE,22,0,0,58,80,186.0
Aryan,2015,MALE,15,0,0,0,15,402.0
Aryeh,2015,MALE,0,0,0,31,31,271.0
Asher,2015,MALE,39,42,0,237,318,96.0
Ashton,2015,MALE,0,44,38,0,82,179.0
August,2015,MALE,0,24,0,54,78,188.0
Austin,2015,MALE,240,104,164,44,552,60.0
Avery,2015,MALE,0,63,57,36,156,134.0
Avi,2015,MALE,0,0,0,17,17,371.0
Avraham,2015,MALE,0,0,0,47,47,237.0
Avrohom,2015,MALE,0,0,0,30,30,275.0
Avrum,2015,MALE,0,0,0,13,13,450.0
Axel,2015,MALE,0,0,92,36,128,147.0
Ayaan,2015,MALE,35,0,0,0,35,260.0
Ayan,2015,MALE,17,0,0,0,17,371.0
Ayden,2015,MALE,88,220,304,68,680,50.0
Aydin,2015,MALE,13,0,0,0,13,450.0
Baruch,2015,MALE,0,0,0,20,20,338.0
Beckett,2015,MALE,0,0,0,17,17,371.0
Ben,2015,MALE,0,0,0,17,17,371.0
Benjamin,2015,MALE,188,84,324,936,1532,19.0
Bennett,2015,MALE,0,0,0,28,28,284.0
Benson,2015,MALE,18,0,0,0,18,359.0
Bentzion,2015,MALE,0,0,0,10,10,547.0
Benzion,2015,MALE,0,0,0,26,26,296.0
Berish,2015,MALE,0,0,0,11,11,513.0
Berl,2015,MALE,0,0,0,16,16,389.0
Binyomin,2015,MALE,0,0,0,14,14,424.0
Blake,2015,MALE,0,36,0,52,88,173.0
Boruch,2015,MALE,0,0,0,14,14,424.0
Boubacar,2015,MALE,0,12,0,0,12,479.0
Bradley,2015,MALE,30,0,96,36,162,130.0
Brady,2015,MALE,0,0,0,14,14,424.0
Brandon,2015,MALE,148,116,388,132,784,42.0
Brayan,2015,MALE,0,0,23,0,23,314.0
Brayden,2015,MALE,54,0,72,33,159,133.0
Brendan,2015,MALE,0,0,0,15,15,402.0
Brian,2015,MALE,81,0,87,60,228,112.0
Brody,2015,MALE,0,0,0,17,17,371.0
Brooks,2015,MALE,0,0,0,13,13,450.0
Bruce,2015,MALE,0,0,14,0,14,424.0
Bruno,2015,MALE,0,0,10,0,10,547.0
Bryan,2015,MALE,96,68,232,44,440,72.0
Bryant,2015,MALE,0,0,13,0,13,450.0
Bryce,2015,MALE,0,50,26,0,76,191.0
Bryson,2015,MALE,0,13,0,0,13,450.0
Byron,2015,MALE,0,0,16,0,16,389.0
Caden,2015,MALE,0,12,0,0,12,479.0
Caiden,2015,MALE,0,19,0,0,19,346.0
Caleb,2015,MALE,76,180,232,176,664,51.0
Calvin,2015,MALE,0,0,0,22,22,323.0
Camden,2015,MALE,0,15,0,0,15,402.0
Cameron,2015,MALE,48,216,80,96,440,72.0
Carlos,2015,MALE,0,0,75,0,75,196.0
Carson,2015,MALE,19,0,0,0,19,346.0
Carter,2015,MALE,0,255,72,78,405,79.0
Cayden,2015,MALE,0,15,0,0,15,402.0
Cesar,2015,MALE,0,0,30,0,30,275.0
Chace,2015,MALE,0,11,0,0,11,513.0
Chad,2015,MALE,0,11,0,0,11,513.0
Chaim,2015,MALE,0,0,0,151,151,138.0
Chance,2015,MALE,0,20,0,0,20,338.0
Charles,2015,MALE,66,0,33,378,477,69.0
Charlie,2015,MALE,0,0,22,34,56,221.0
Chase,2015,MALE,44,272,96,140,552,60.0
Cheskel,2015,MALE,0,0,0,15,15,402.0
Chris,2015,MALE,26,0,42,0,68,203.0
Christian,2015,MALE,68,260,388,184,900,37.0
Christopher,2015,MALE,96,140,608,304,1148,27.0
Clark,2015,MALE,0,0,0,13,13,450.0
Cole,2015,MALE,0,0,0,25,25,302.0
Colin,2015,MALE,20,0,0,62,82,179.0
Colton,2015,MALE,0,0,0,10,10,547.0
Connor,2015,MALE,72,42,0,135,249,110.0
Conor,2015,MALE,0,0,0,10,10,547.0
Cooper,2015,MALE,0,0,0,32,32,268.0
Corey,2015,MALE,0,10,0,0,10,547.0
Cristian,2015,MALE,0,0,33,0,33,265.0
Cristopher,2015,MALE,0,0,12,0,12,479.0
Crosby,2015,MALE,0,0,0,11,11,513.0
Dallas,2015,MALE,0,12,0,0,12,479.0
Damian,2015,MALE,0,0,34,0,34,263.0
Damien,2015,MALE,0,0,13,0,13,450.0
Damon,2015,MALE,10,0,0,0,10,547.0
Daniel,2015,MALE,232,156,848,880,2116,8.0
Danny,2015,MALE,0,0,23,0,23,314.0
Dante,2015,MALE,0,0,12,0,12,479.0
Dariel,2015,MALE,0,0,28,0,28,284.0
Darren,2015,MALE,24,0,0,0,24,308.0
Darwin,2015,MALE,0,0,11,0,11,513.0
David,2015,MALE,140,232,612,1196,2180,7.0
Dean,2015,MALE,24,0,0,54,78,188.0
Declan,2015,MALE,0,0,0,44,44,241.0
Derek,2015,MALE,52,0,102,0,154,135.0
Derrick,2015,MALE,11,0,0,0,11,513.0
Devin,2015,MALE,38,0,26,0,64,207.0
Diego,2015,MALE,0,0,54,0,54,223.0
Dominic,2015,MALE,0,42,87,90,219,113.0
Dominick,2015,MALE,0,0,34,28,62,211.0
Dov,2015,MALE,0,0,0,41,41,250.0
Dovid,2015,MALE,0,0,0,35,35,260.0
Drew,2015,MALE,0,0,0,17,17,371.0
Duvid,2015,MALE,0,0,0,10,10,547.0
Dylan,2015,MALE,196,160,1356,388,2100,9.0
Ean,2015,MALE,0,0,17,0,17,371.0
Eason,2015,MALE,32,0,0,0,32,268.0
Eden,2015,MALE,11,0,0,0,11,513.0
Edgar,2015,MALE,0,0,19,0,19,346.0
Edison,2015,MALE,24,0,24,0,48,235.0
Eduardo,2015,MALE,0,0,12,0,12,479.0
Edward,2015,MALE,36,0,114,120,270,104.0
Edwin,2015,MALE,26,0,64,0,90,172.0
Efraim,2015,MALE,0,0,0,24,24,308.0
Eitan,2015,MALE,0,0,0,14,14,424.0
Eli,2015,MALE,0,66,129,312,507,65.0
Eliam,2015,MALE,0,0,13,0,13,450.0
Elian,2015,MALE,0,0,25,0,25,302.0
Elias,2015,MALE,0,48,195,66,309,98.0
Eliezer,2015,MALE,0,0,0,41,41,250.0
Elijah,2015,MALE,56,432,320,164,972,34.0
Elimelech,2015,MALE,0,0,0,19,19,346.0
Eliot,2015,MALE,0,0,0,10,10,547.0
Eliyahu,2015,MALE,0,0,0,44,44,241.0
Elliot,2015,MALE,0,0,24,88,112,155.0
Elliott,2015,MALE,0,0,0,18,18,359.0
Ellis,2015,MALE,0,0,0,12,12,479.0
Eluzer,2015,MALE,0,0,0,12,12,479.0
Emanuel,2015,MALE,0,0,23,0,23,314.0
Emiliano,2015,MALE,0,0,19,0,19,346.0
Emilio,2015,MALE,0,0,21,0,21,332.0
Emmanuel,2015,MALE,0,108,237,33,378,83.0
Emmett,2015,MALE,0,0,0,21,21,332.0
Enrique,2015,MALE,0,0,14,0,14,424.0
Enzo,2015,MALE,0,0,17,0,17,371.0
Ephraim,2015,MALE,0,0,0,14,14,424.0
Eric,2015,MALE,264,52,124,76,516,64.0
Erick,2015,MALE,0,0,60,0,60,213.0
Eshan,2015,MALE,10,0,0,0,10,547.0
Esteban,2015,MALE,0,0,17,0,17,371.0
Ethan,2015,MALE,688,444,1328,552,3012,1.0
Evan,2015,MALE,284,56,260,128,728,47.0
Everett,2015,MALE,0,0,0,16,16,389.0
Ezekiel,2015,MALE,0,0,10,0,10,547.0
Ezequiel,2015,MALE,0,0,10,0,10,547.0
Ezra,2015,MALE,0,22,0,102,124,149.0
Ezriel,2015,MALE,0,0,0,14,14,424.0
Fabian,2015,MALE,0,0,23,0,23,314.0
Felix,2015,MALE,42,0,54,114,210,114.0
Fernando,2015,MALE,0,0,17,0,17,371.0
Feynman,2015,MALE,14,0,0,0,14,424.0
Finn,2015,MALE,0,0,0,38,38,253.0
Francesco,2015,MALE,0,0,0,12,12,479.0
Francis,2015,MALE,0,0,20,30,50,231.0
Francisco,2015,MALE,0,0,15,0,15,402.0
Frank,2015,MALE,0,0,30,38,68,203.0
Franklin,2015,MALE,0,0,12,0,12,479.0
Frederick,2015,MALE,0,0,0,25,25,302.0
Gabriel,2015,MALE,64,204,496,492,1256,25.0
Gael,2015,MALE,0,0,37,0,37,256.0
Gary,2015,MALE,15,0,0,0,15,402.0
Gavin,2015,MALE,60,0,48,102,210,114.0
Gavriel,2015,MALE,0,0,0,11,11,513.0
George,2015,MALE,48,0,39,237,324,94.0
Giovanni,2015,MALE,0,42,90,123,255,107.0
Graham,2015,MALE,0,0,0,20,20,338.0
Grant,2015,MALE,0,0,0,25,25,302.0
Grayson,2015,MALE,56,44,76,136,312,97.0
Gregory,2015,MALE,0,0,20,32,52,228.0
Greyson,2015,MALE,0,0,0,12,12,479.0
Griffin,2015,MALE,0,0,0,18,18,359.0
Hamza,2015,MALE,0,0,0,25,25,302.0
Harrison,2015,MALE,26,0,0,94,120,150.0
Harry,2015,MALE,20,0,0,34,54,223.0
Hector,2015,MALE,0,0,23,0,23,314.0
Henry,2015,MALE,138,0,81,534,753,45.0
Hersh,2015,MALE,0,0,0,13,13,450.0
Hershel,2015,MALE,0,0,0,26,26,296.0
Hershy,2015,MALE,0,0,0,29,29,280.0
Hudson,2015,MALE,39,0,30,219,288,102.0
Hugo,2015,MALE,0,0,0,22,22,323.0
Hunter,2015,MALE,88,148,124,160,520,63.0
Ian,2015,MALE,116,84,392,64,656,52.0
Ibrahim,2015,MALE,99,54,0,42,195,119.0
Ibrahima,2015,MALE,0,11,0,0,11,513.0
Iker,2015,MALE,0,0,82,0,82,179.0
Isaac,2015,MALE,84,116,496,428,1124,28.0
Isaiah,2015,MALE,0,198,189,30,417,78.0
Isaias,2015,MALE,0,0,12,0,12,479.0
Ismael,2015,MALE,0,0,20,0,20,338.0
Israel,2015,MALE,0,48,54,72,174,126.0
Ivan,2015,MALE,117,0,102,75,294,100.0
Jabari,2015,MALE,0,10,0,0,10,547.0
Jace,2015,MALE,0,94,96,0,190,120.0
Jack,2015,MALE,42,0,84,561,687,49.0
Jackson,2015,MALE,68,44,72,304,488,66.0
Jacky,2015,MALE,13,0,0,0,13,450.0
Jacob,2015,MALE,184,268,1172,944,2568,4.0
Jaden,2015,MALE,108,87,126,0,321,95.0
Jadiel,2015,MALE,0,0,45,0,45,240.0
Jael,2015,MALE,0,0,12,0,12,479.0
Jaheim,2015,MALE,0,10,0,0,10,547.0
Jahmir,2015,MALE,0,12,0,0,12,479.0
Jaiden,2015,MALE,0,30,38,0,68,203.0
Jaime,2015,MALE,0,0,15,0,15,402.0
Jake,2015,MALE,0,0,82,100,182,122.0
Jamal,2015,MALE,0,10,0,0,10,547.0
James,2015,MALE,224,112,440,836,1612,18.0
Jameson,2015,MALE,0,0,0,14,14,424.0
Jamir,2015,MALE,0,11,0,0,11,513.0
Jared,2015,MALE,0,0,26,0,26,296.0
Jariel,2015,MALE,0,0,10,0,10,547.0
Jasiah,2015,MALE,0,10,0,0,10,547.0
Jason,2015,MALE,284,84,208,112,688,48.0
Jasper,2015,MALE,62,0,0,50,112,155.0
Javier,2015,MALE,0,0,24,0,24,308.0
Jaxon,2015,MALE,0,33,66,54,153,136.0
Jaxson,2015,MALE,0,0,26,20,46,238.0
Jay,2015,MALE,11,0,0,0,11,513.0
Jayce,2015,MALE,0,54,76,0,130,145.0
Jayceon,2015,MALE,0,23,0,0,23,314.0
Jayden,2015,MALE,760,336,1068,104,2268,5.0
Jaylen,2015,MALE,0,17,0,0,17,371.0
Jayson,2015,MALE,0,0,13,0,13,450.0
Jean,2015,MALE,0,0,11,0,11,513.0
Jefferson,2015,MALE,0,0,17,0,17,371.0
Jeffrey,2015,MALE,52,0,42,0,94,168.0
Jeremiah,2015,MALE,0,226,194,0,420,77.0
Jeremy,2015,MALE,120,40,424,64,648,53.0
Jerry,2015,MALE,18,0,0,0,18,359.0
Jesse,2015,MALE,0,0,0,14,14,424.0
Jesus,2015,MALE,0,0,60,0,60,213.0
Jimmy,2015,MALE,18,0,0,0,18,359.0
Joaquin,2015,MALE,0,0,16,0,16,389.0
Joel,2015,MALE,0,60,216,96,372,84.0
Johan,2015,MALE,0,0,30,0,30,275.0
John,2015,MALE,68,80,264,556,968,35.0
Johnny,2015,MALE,10,0,0,0,10,547.0
Jonael,2015,MALE,0,0,12,0,12,479.0
Jonah,2015,MALE,0,0,44,104,148,139.0
Jonas,2015,MALE,0,0,12,0,12,479.0
Jonathan,2015,MALE,156,120,464,252,992,33.0
Jordan,2015,MALE,0,120,138,114,372,84.0
Jordi,2015,MALE,0,0,12,0,12,479.0
Jorge,2015,MALE,0,0,38,0,38,253.0
Jose,2015,MALE,0,0,102,0,102,162.0
Josef,2015,MALE,0,0,0,10,10,547.0
Joseph,2015,MALE,88,148,536,1116,1888,13.0
Joshua,2015,MALE,112,388,492,324,1316,23.0
Josiah,2015,MALE,36,333,219,0,588,57.0
Josue,2015,MALE,0,0,29,0,29,280.0
Joziah,2015,MALE,0,0,10,0,10,547.0
Juan,2015,MALE,0,0,55,0,55,222.0
Judah,2015,MALE,0,0,0,33,33,265.0
Jude,2015,MALE,0,0,0,30,30,275.0
Julian,2015,MALE,88,76,360,276,800,41.0
Julien,2015,MALE,0,0,10,0,10,547.0
Julio,2015,MALE,0,0,11,0,11,513.0
Julius,2015,MALE,0,0,42,0,42,245.0
Justice,2015,MALE,0,14,0,0,14,424.0
Justin,2015,MALE,188,152,416,132,888,38.0
Kaden,2015,MALE,20,40,0,0,60,213.0
Kai,2015,MALE,69,66,0,69,204,118.0
Kaiden,2015,MALE,0,98,64,0,162,130.0
Kaleb,2015,MALE,0,32,28,0,60,213.0
Kamari,2015,MALE,0,10,0,0,10,547.0
Kameron,2015,MALE,0,11,0,0,11,513.0
Karas,2015,MALE,0,0,0,11,11,513.0
Kareem,2015,MALE,0,14,0,0,14,424.0
Karter,2015,MALE,0,82,20,0,102,162.0
Kayden,2015,MALE,48,165,153,0,366,87.0
Kazi,2015,MALE,10,0,0,0,10,547.0
Kelvin,2015,MALE,0,0,10,0,10,547.0
Kenneth,2015,MALE,0,34,42,0,76,191.0
Kenny,2015,MALE,20,0,22,0,42,245.0
Kevin,2015,MALE,184,100,364,120,768,44.0
Khalil,2015,MALE,0,14,0,0,14,424.0
Kian,2015,MALE,0,0,0,11,11,513.0
Kieran,2015,MALE,0,0,0,10,10,547.0
Kimi,2015,MALE,22,0,0,0,22,323.0
King,2015,MALE,0,122,58,0,180,123.0
Kingsley,2015,MALE,16,0,0,0,16,389.0
Kyle,2015,MALE,176,136,92,44,448,71.0
Kymani,2015,MALE,0,12,0,0,12,479.0
Kyrie,2015,MALE,0,72,24,0,96,164.0
Landon,2015,MALE,36,0,60,36,132,143.0
Lawrence,2015,MALE,15,0,0,0,15,402.0
Lazer,2015,MALE,0,0,0,20,20,338.0
Leandro,2015,MALE,0,0,16,0,16,389.0
Legend,2015,MALE,0,11,0,0,11,513.0
Lenny,2015,MALE,0,0,10,0,10,547.0
Leo,2015,MALE,176,40,164,468,848,39.0
Leon,2015,MALE,56,40,52,124,272,103.0
Leonardo,2015,MALE,0,0,118,60,178,124.0
Leonel,2015,MALE,0,0,10,0,10,547.0
Leonidas,2015,MALE,0,0,13,0,13,450.0
Lev,2015,MALE,0,0,0,20,20,338.0
Levi,2015,MALE,0,45,69,153,267,105.0
Liam,2015,MALE,280,516,1424,544,2764,2.0
Lincoln,2015,MALE,0,0,0,18,18,359.0
Lipa,2015,MALE,0,0,0,28,28,284.0
Logan,2015,MALE,92,336,532,336,1296,24.0
Lorenzo,2015,MALE,0,0,48,48,96,164.0
Louis,2015,MALE,45,0,33,93,171,127.0
Luca,2015,MALE,45,0,63,330,438,74.0
Lucas,2015,MALE,488,84,760,516,1848,14.0
Luis,2015,MALE,0,0,86,0,86,176.0
Luka,2015,MALE,0,0,0,18,18,359.0
Lukas,2015,MALE,0,0,46,46,92,170.0
Luke,2015,MALE,92,68,68,364,592,56.0
Major,2015,MALE,0,15,0,0,15,402.0
Makai,2015,MALE,0,11,0,0,11,513.0
Malachi,2015,MALE,0,42,0,0,42,245.0
Malik,2015,MALE,0,20,0,22,42,245.0
Mamadou,2015,MALE,0,23,0,0,23,314.0
Manuel,2015,MALE,0,0,27,0,27,293.0
Marc,2015,MALE,0,0,20,38,58,219.0
Marco,2015,MALE,0,0,42,30,72,199.0
Marcos,2015,MALE,0,0,26,0,26,296.0
Marcus,2015,MALE,72,80,52,60,264,106.0
Mario,2015,MALE,0,0,18,0,18,359.0
Mark,2015,MALE,0,26,0,106,132,143.0
Martin,2015,MALE,0,0,34,42,76,191.0
Mason,2015,MALE,256,412,696,272,1636,17.0
Mateo,2015,MALE,0,0,212,34,246,111.0
Mathew,2015,MALE,0,0,17,0,17,371.0
Mathias,2015,MALE,0,0,15,0,15,402.0
Matias,2015,MALE,0,0,22,0,22,323.0
Matteo,2015,MALE,0,0,78,60,138,142.0
Matthew,2015,MALE,272,224,1232,520,2248,6.0
Mauricio,2015,MALE,0,0,10,0,10,547.0
Max,2015,MALE,81,0,87,315,483,68.0
Maxim,2015,MALE,0,0,0,19,19,346.0
Maximilian,2015,MALE,0,0,0,28,28,284.0
Maximiliano,2015,MALE,0,0,17,0,17,371.0
Maximus,2015,MALE,0,0,58,24,82,179.0
Maxwell,2015,MALE,64,56,68,196,384,82.0
Mayer,2015,MALE,0,0,0,22,22,323.0
Meir,2015,MALE,0,0,0,46,46,238.0
Mekhi,2015,MALE,0,14,0,0,14,424.0
Menachem,2015,MALE,0,0,0,91,91,171.0
Menashe,2015,MALE,0,0,0,10,10,547.0
Mendel,2015,MALE,0,0,0,42,42,245.0
Mendy,2015,MALE,0,0,0,24,24,308.0
Meshilem,2015,MALE,0,0,0,12,12,479.0
Messiah,2015,MALE,0,112,32,0,144,140.0
Micah,2015,MALE,0,72,0,38,110,158.0
Michael,2015,MALE,144,312,600,924,1980,11.0
Miguel,2015,MALE,0,0,62,0,62,211.0
Milan,2015,MALE,0,0,35,0,35,260.0
Miles,2015,MALE,48,33,0,216,297,99.0
Milo,2015,MALE,0,0,0,28,28,284.0
Mohamed,2015,MALE,30,138,0,126,294,100.0
Mohammad,2015,MALE,134,0,0,26,160,132.0
Mohammed,2015,MALE,68,0,0,50,118,152.0
Moises,2015,MALE,0,0,13,0,13,450.0
Moishe,2015,MALE,0,0,0,28,28,284.0
Mordechai,2015,MALE,0,0,0,76,76,191.0
Morris,2015,MALE,0,0,0,19,19,346.0
Moses,2015,MALE,0,0,0,28,28,284.0
Moshe,2015,MALE,0,0,0,254,254,109.0
Moussa,2015,MALE,0,10,0,0,10,547.0
Muhammad,2015,MALE,462,42,0,60,564,59.0
Musa,2015,MALE,16,0,0,0,16,389.0
Mustafa,2015,MALE,11,0,0,0,11,513.0
Myles,2015,MALE,0,13,0,0,13,450.0
Nachman,2015,MALE,0,0,0,20,20,338.0
Naftali,2015,MALE,0,0,0,31,31,271.0
Naftuli,2015,MALE,0,0,0,17,17,371.0
Nasir,2015,MALE,0,31,0,0,31,271.0
Nathan,2015,MALE,204,200,260,332,996,32.0
Nathaniel,2015,MALE,108,188,256,220,772,43.0
Neil,2015,MALE,10,0,0,0,10,547.0
Nelson,2015,MALE,30,0,24,0,54,223.0
Neymar,2015,MALE,0,0,12,0,12,479.0
Nicholas,2015,MALE,156,128,284,556,1124,28.0
Nico,2015,MALE,0,0,0,12,12,479.0
Nicolas,2015,MALE,0,0,102,50,152,137.0
Noach,2015,MALE,0,0,0,11,11,513.0
Noah,2015,MALE,228,652,1188,544,2612,3.0
Noam,2015,MALE,0,0,0,23,23,314.0
Noel,2015,MALE,0,28,48,0,76,191.0
Nolan,2015,MALE,24,0,0,48,72,199.0
Oliver,2015,MALE,168,0,156,495,819,40.0
Omar,2015,MALE,0,39,54,162,255,107.0
Omari,2015,MALE,0,24,0,0,24,308.0
Oren,2015,MALE,0,0,0,11,11,513.0
Oscar,2015,MALE,84,0,105,147,336,92.0
Otis,2015,MALE,0,0,0,10,10,547.0
Otto,2015,MALE,0,0,0,13,13,450.0
Ousmane,2015,MALE,0,10,0,0,10,547.0
Owen,2015,MALE,180,48,92,264,584,58.0
Pablo,2015,MALE,0,0,14,0,14,424.0
Parker,2015,MALE,20,0,0,52,72,199.0
Patrick,2015,MALE,0,0,0,37,37,256.0
Paul,2015,MALE,0,0,28,52,80,186.0
Pedro,2015,MALE,0,0,22,0,22,323.0
Peretz,2015,MALE,0,0,0,12,12,479.0
Peter,2015,MALE,0,0,28,84,112,155.0
Peyton,2015,MALE,0,10,0,0,10,547.0
Philip,2015,MALE,0,0,0,12,12,479.0
Phoenix,2015,MALE,0,0,0,16,16,389.0
Pierce,2015,MALE,0,0,0,15,15,402.0
Pinchas,2015,MALE,0,0,0,16,16,389.0
Pinchus,2015,MALE,0,0,0,13,13,450.0
Preston,2015,MALE,36,63,30,0,129,146.0
Prince,2015,MALE,0,82,26,0,108,159.0
Princeton,2015,MALE,0,12,0,0,12,479.0
Quincy,2015,MALE,0,10,0,0,10,547.0
Quinn,2015,MALE,0,0,0,14,14,424.0
Rafael,2015,MALE,0,0,54,66,120,150.0
Randy,2015,MALE,0,0,14,0,14,424.0
Raphael,2015,MALE,0,0,0,19,19,346.0
Rayan,2015,MALE,54,0,0,42,96,164.0
Raymond,2015,MALE,72,0,0,22,94,168.0
Rayyan,2015,MALE,16,0,0,0,16,389.0
Reid,2015,MALE,0,0,0,12,12,479.0
Reuven,2015,MALE,0,0,0,11,11,513.0
Rhys,2015,MALE,0,0,0,10,10,547.0
Ricardo,2015,MALE,0,0,23,0,23,314.0
Richard,2015,MALE,104,76,108,80,368,86.0
Ricky,2015,MALE,11,0,0,0,11,513.0
Riley,2015,MALE,0,10,0,0,10,547.0
Robert,2015,MALE,0,54,69,264,387,81.0
Roberto,2015,MALE,0,0,15,0,15,402.0
Rocco,2015,MALE,0,0,0,19,19,346.0
Rohan,2015,MALE,14,0,0,0,14,424.0
Roman,2015,MALE,0,36,63,78,177,125.0
Romeo,2015,MALE,0,0,13,0,13,450.0
Ronald,2015,MALE,0,0,14,0,14,424.0
Ronaldo,2015,MALE,0,0,10,0,10,547.0
Ronan,2015,MALE,0,0,0,17,17,371.0
Rory,2015,MALE,0,0,0,11,11,513.0
Rowan,2015,MALE,0,0,0,17,17,371.0
Roy,2015,MALE,11,0,0,0,11,513.0
Royal,2015,MALE,0,14,0,0,14,424.0
Ryan,2015,MALE,684,164,372,476,1696,15.0
Ryder,2015,MALE,26,0,0,48,74,197.0
Saifan,2015,MALE,12,0,0,0,12,479.0
Salvatore,2015,MALE,0,0,0,25,25,302.0
Sam,2015,MALE,0,0,0,33,33,265.0
Samir,2015,MALE,0,0,0,13,13,450.0
Samuel,2015,MALE,112,152,308,852,1424,20.0
Santiago,2015,MALE,0,0,44,0,44,241.0
Saul,2015,MALE,0,0,30,20,50,231.0
Sawyer,2015,MALE,0,0,0,18,18,359.0
Sean,2015,MALE,54,36,0,81,171,127.0
Sebastian,2015,MALE,84,112,1060,392,1648,16.0
Selim,2015,MALE,0,0,0,13,13,450.0
Sergio,2015,MALE,0,0,13,0,13,450.0
Seth,2015,MALE,0,0,32,20,52,228.0
Shalom,2015,MALE,0,0,0,18,18,359.0
Shane,2015,MALE,0,0,0,16,16,389.0
Shawn,2015,MALE,0,17,0,0,17,371.0
Shaya,2015,MALE,0,0,0,34,34,263.0
Shea,2015,MALE,0,0,0,13,13,450.0
Shia,2015,MALE,0,0,0,30,30,275.0
Shimon,2015,MALE,0,0,0,115,115,153.0
Shloime,2015,MALE,0,0,0,18,18,359.0
Shloimy,2015,MALE,0,0,0,14,14,424.0
Shloma,2015,MALE,0,0,0,19,19,346.0
Shlome,2015,MALE,0,0,0,26,26,296.0
Shlomo,2015,MALE,0,0,0,69,69,202.0
Shmiel,2015,MALE,0,0,0,38,38,253.0
Shmuel,2015,MALE,0,0,0,63,63,209.0
Sholom,2015,MALE,0,0,0,21,21,332.0
Shulem,2015,MALE,0,0,0,31,31,271.0
Silas,2015,MALE,0,0,0,13,13,450.0
Simcha,2015,MALE,0,0,0,28,28,284.0
Simon,2015,MALE,0,0,0,51,51,230.0
Sincere,2015,MALE,0,19,0,0,19,346.0
Solomon,2015,MALE,0,0,0,54,54,223.0
Spencer,2015,MALE,0,0,0,21,21,332.0
Stanley,2015,MALE,11,0,0,0,11,513.0
Stephen,2015,MALE,0,20,20,0,40,252.0
Steven,2015,MALE,80,60,244,100,484,67.0
Syed,2015,MALE,29,0,0,0,29,280.0
Tenzin,2015,MALE,27,0,0,0,27,293.0
Theo,2015,MALE,0,0,0,27,27,293.0
Theodore,2015,MALE,40,0,0,294,334,93.0
Thiago,2015,MALE,0,0,48,0,48,235.0
Thomas,2015,MALE,68,48,100,424,640,54.0
Timothy,2015,MALE,32,0,0,28,60,213.0
Timur,2015,MALE,0,0,0,12,12,479.0
Tony,2015,MALE,10,0,0,0,10,547.0
Tristan,2015,MALE,72,152,124,88,436,75.0
Tyler,2015,MALE,116,248,180,200,744,46.0
Tzvi,2015,MALE,0,0,0,53,53,227.0
Uriel,2015,MALE,0,0,12,0,12,479.0
Usher,2015,MALE,0,0,0,24,24,308.0
Valentino,2015,MALE,0,0,10,0,10,547.0
Victor,2015,MALE,40,48,168,132,388,80.0
Vincent,2015,MALE,135,0,63,159,357,90.0
Vincenzo,2015,MALE,0,0,0,12,12,479.0
Walter,2015,MALE,0,0,0,11,11,513.0
Wesley,2015,MALE,57,0,30,81,168,129.0
William,2015,MALE,340,76,264,720,1400,21.0
Wilson,2015,MALE,16,0,0,0,16,389.0
Winston,2015,MALE,0,0,0,11,11,513.0
Wolf,2015,MALE,0,0,0,15,15,402.0
Wyatt,2015,MALE,0,24,0,58,82,179.0
Xander,2015,MALE,0,0,13,0,13,450.0
Xavier,2015,MALE,52,172,256,48,528,62.0
Yaakov,2015,MALE,0,0,0,64,64,207.0
Yadiel,2015,MALE,0,0,22,0,22,323.0
Yahir,2015,MALE,0,0,11,0,11,513.0
Yahya,2015,MALE,0,0,0,10,10,547.0
Yakov,2015,MALE,0,0,0,63,63,209.0
Yariel,2015,MALE,0,0,14,0,14,424.0
Yaseen,2015,MALE,0,0,0,22,22,323.0
Yechiel,2015,MALE,0,0,0,29,29,280.0
Yehoshua,2015,MALE,0,0,0,22,22,323.0
Yehuda,2015,MALE,0,0,0,83,83,178.0
Yisrael,2015,MALE,0,0,0,12,12,479.0
Yisroel,2015,MALE,0,0,0,88,88,173.0
Yitzchok,2015,MALE,0,0,0,81,81,185.0
Yoel,2015,MALE,0,0,0,15,15,402.0
Yosef,2015,MALE,0,0,0,105,105,160.0
Yossi,2015,MALE,0,0,0,12,12,479.0
Yousef,2015,MALE,0,0,0,13,13,450.0
Youssef,2015,MALE,0,0,0,19,19,346.0
Yusuf,2015,MALE,34,0,0,44,78,188.0
Zachary,2015,MALE,104,80,108,324,616,55.0
Zain,2015,MALE,0,0,0,12,12,479.0
Zaire,2015,MALE,0,20,0,0,20,338.0
Zalmen,2015,MALE,0,0,0,15,15,402.0
Zayan,2015,MALE,11,0,0,0,11,513.0
Zayden,2015,MALE,0,26,32,0,58,219.0
Zev,2015,MALE,0,0,0,44,44,241.0
Zion,2015,MALE,0,84,20,0,104,161.0
Aaliyah,2016,FEMALE,0,114,112,0,226,84.0
Abby,2016,FEMALE,31,0,0,0,31,280.0
Abigail,2016,FEMALE,128,192,468,328,1116,13.0
Ada,2016,FEMALE,0,0,0,20,20,342.0
Addison,2016,FEMALE,0,26,0,54,80,181.0
Adelaide,2016,FEMALE,0,0,0,14,14,451.0
Adele,2016,FEMALE,0,0,0,32,32,274.0
Adeline,2016,FEMALE,0,0,20,62,82,174.0
Adelyn,2016,FEMALE,0,0,11,0,11,558.0
Adina,2016,FEMALE,0,0,0,19,19,354.0
Adriana,2016,FEMALE,0,0,74,34,108,146.0
Adrianna,2016,FEMALE,0,0,0,12,12,511.0
Ahuva,2016,FEMALE,0,0,0,22,22,327.0
Aicha,2016,FEMALE,0,11,0,0,11,558.0
Aileen,2016,FEMALE,20,0,28,0,48,246.0
Aisha,2016,FEMALE,50,66,0,0,116,137.0
Aissatou,2016,FEMALE,0,11,0,0,11,558.0
Aizah,2016,FEMALE,20,0,0,0,20,342.0
Alaia,2016,FEMALE,0,0,66,0,66,209.0
Alaina,2016,FEMALE,0,0,11,0,11,558.0
Alana,2016,FEMALE,0,0,26,0,26,304.0
Alani,2016,FEMALE,0,30,24,0,54,232.0
Alanna,2016,FEMALE,0,0,11,0,11,558.0
Alayna,2016,FEMALE,0,0,10,0,10,607.0
Aleah,2016,FEMALE,0,0,14,0,14,451.0
Aleena,2016,FEMALE,23,0,0,0,23,321.0
Alejandra,2016,FEMALE,0,0,17,0,17,383.0
Alessandra,2016,FEMALE,0,0,32,38,70,200.0
Alessia,2016,FEMALE,0,0,0,21,21,334.0
Alexa,2016,FEMALE,0,0,170,72,242,79.0
Alexandra,2016,FEMALE,69,0,69,297,435,43.0
Alexis,2016,FEMALE,0,39,33,66,138,117.0
Alia,2016,FEMALE,0,0,12,0,12,511.0
Aliah,2016,FEMALE,0,0,12,0,12,511.0
Alice,2016,FEMALE,84,0,102,213,399,48.0
Alicia,2016,FEMALE,0,0,15,0,15,421.0
Alina,2016,FEMALE,117,0,75,57,249,77.0
Alisa,2016,FEMALE,0,0,0,11,11,558.0
Alisha,2016,FEMALE,17,0,0,0,17,383.0
Alison,2016,FEMALE,0,0,24,0,24,315.0
Aliyah,2016,FEMALE,30,54,75,0,159,105.0
Aliza,2016,FEMALE,0,0,0,15,15,421.0
Allison,2016,FEMALE,40,0,194,0,234,80.0
Allyson,2016,FEMALE,0,0,14,0,14,451.0
Alma,2016,FEMALE,0,0,0,18,18,366.0
Alondra,2016,FEMALE,0,0,19,0,19,354.0
Alyssa,2016,FEMALE,76,80,156,68,380,51.0
Amaia,2016,FEMALE,0,0,23,0,23,321.0
Amalia,2016,FEMALE,0,0,40,38,78,184.0
Amanda,2016,FEMALE,48,0,75,36,159,105.0
Amara,2016,FEMALE,24,24,0,0,48,246.0
Amaya,2016,FEMALE,39,66,111,0,216,85.0
Amayah,2016,FEMALE,0,0,11,0,11,558.0
Amber,2016,FEMALE,32,0,64,0,96,157.0
Amelia,2016,FEMALE,176,148,264,396,984,15.0
Amelie,2016,FEMALE,0,0,0,15,15,421.0
Amina,2016,FEMALE,44,96,40,168,348,56.0
Aminata,2016,FEMALE,0,27,0,0,27,296.0
Amira,2016,FEMALE,20,30,0,0,50,241.0
Amirah,2016,FEMALE,0,28,26,0,54,232.0
Amiyah,2016,FEMALE,0,24,0,0,24,315.0
Amy,2016,FEMALE,81,0,156,39,276,71.0
Ana,2016,FEMALE,0,0,78,20,98,153.0
Anabia,2016,FEMALE,10,0,0,0,10,607.0
Analia,2016,FEMALE,0,0,15,0,15,421.0
Anastasia,2016,FEMALE,0,0,26,58,84,173.0
Anaya,2016,FEMALE,102,48,33,0,183,96.0
Andrea,2016,FEMALE,0,0,39,0,39,262.0
Angel,2016,FEMALE,13,0,0,0,13,488.0
Angela,2016,FEMALE,108,0,28,0,136,119.0
Angelica,2016,FEMALE,0,0,22,0,22,327.0
Angelina,2016,FEMALE,75,0,93,114,282,70.0
Angelique,2016,FEMALE,0,0,12,0,12,511.0
Angie,2016,FEMALE,0,0,18,0,18,366.0
Aniyah,2016,FEMALE,0,18,0,0,18,366.0
Anjali,2016,FEMALE,10,0,0,0,10,607.0
Anna,2016,FEMALE,102,0,33,240,375,53.0
Annabel,2016,FEMALE,0,0,0,15,15,421.0
Annabelle,2016,FEMALE,48,40,72,108,268,74.0
Annalise,2016,FEMALE,0,0,14,0,14,451.0
Anne,2016,FEMALE,24,0,0,22,46,251.0
Annie,2016,FEMALE,26,0,0,0,26,304.0
Antonella,2016,FEMALE,0,0,23,0,23,321.0
Antonia,2016,FEMALE,0,0,0,12,12,511.0
April,2016,FEMALE,0,0,18,0,18,366.0
Arabella,2016,FEMALE,0,0,12,0,12,511.0
Aria,2016,FEMALE,132,132,140,140,544,33.0
Ariah,2016,FEMALE,0,25,0,0,25,308.0
Ariana,2016,FEMALE,160,92,292,148,692,25.0
Arianna,2016,FEMALE,64,140,276,64,544,33.0
Arianny,2016,FEMALE,0,0,11,0,11,558.0
Ariel,2016,FEMALE,38,44,0,0,82,174.0
Ariella,2016,FEMALE,0,0,30,48,78,184.0
Arielle,2016,FEMALE,0,51,33,57,141,115.0
Arisha,2016,FEMALE,10,0,0,0,10,607.0
Arlette,2016,FEMALE,0,0,11,0,11,558.0
Arya,2016,FEMALE,84,0,36,0,120,134.0
Ashley,2016,FEMALE,136,40,400,40,616,28.0
Athena,2016,FEMALE,30,0,42,0,72,195.0
Aubrey,2016,FEMALE,0,54,114,36,204,90.0
Audrey,2016,FEMALE,116,44,84,144,388,49.0
Aurora,2016,FEMALE,0,0,40,34,74,191.0
Autumn,2016,FEMALE,0,123,60,30,213,87.0
Ava,2016,FEMALE,212,436,440,672,1760,6.0
Avery,2016,FEMALE,96,72,152,228,548,32.0
Avigail,2016,FEMALE,0,0,0,18,18,366.0
Aviva,2016,FEMALE,0,0,0,11,11,558.0
Ayat,2016,FEMALE,15,0,0,0,15,421.0
Ayesha,2016,FEMALE,30,0,0,0,30,283.0
Ayla,2016,FEMALE,0,0,0,19,19,354.0
Ayleen,2016,FEMALE,0,0,12,0,12,511.0
Aylin,2016,FEMALE,0,0,27,0,27,296.0
Baila,2016,FEMALE,0,0,0,55,55,230.0
Basya,2016,FEMALE,0,0,0,12,12,511.0
Batsheva,2016,FEMALE,0,0,0,12,12,511.0
Batya,2016,FEMALE,0,0,0,12,12,511.0
Beatrice,2016,FEMALE,0,0,0,18,18,366.0
Belen,2016,FEMALE,0,0,10,0,10,607.0
Bella,2016,FEMALE,108,92,180,96,476,40.0
Bianca,2016,FEMALE,0,0,36,36,72,195.0
Bintou,2016,FEMALE,0,12,0,0,12,511.0
Blake,2016,FEMALE,0,0,0,14,14,451.0
Blessing,2016,FEMALE,0,10,0,0,10,607.0
Blima,2016,FEMALE,0,0,0,34,34,269.0
Blimy,2016,FEMALE,0,0,0,21,21,334.0
Bonnie,2016,FEMALE,11,0,0,0,11,558.0
Bracha,2016,FEMALE,0,0,0,24,24,315.0
Breindy,2016,FEMALE,0,0,0,12,12,511.0
Briana,2016,FEMALE,0,0,21,0,21,334.0
Brianna,2016,FEMALE,40,60,344,56,500,39.0
Briella,2016,FEMALE,0,0,0,10,10,607.0
Brielle,2016,FEMALE,0,114,45,42,201,92.0
Britney,2016,FEMALE,0,0,12,0,12,511.0
Brittany,2016,FEMALE,0,0,22,0,22,327.0
Brooke,2016,FEMALE,0,28,0,38,66,209.0
Brooklyn,2016,FEMALE,0,0,0,10,10,607.0
Brucha,2016,FEMALE,0,0,0,14,14,451.0
Bruchy,2016,FEMALE,0,0,0,16,16,397.0
Bryanna,2016,FEMALE,0,0,14,0,14,451.0
Brynn,2016,FEMALE,0,0,0,10,10,607.0
Cali,2016,FEMALE,0,12,0,0,12,511.0
Camila,2016,FEMALE,0,0,360,22,382,50.0
Camilla,2016,FEMALE,0,0,26,34,60,221.0
Camille,2016,FEMALE,0,0,0,12,12,511.0
Carina,2016,FEMALE,12,0,0,0,12,511.0
Carla,2016,FEMALE,0,0,14,0,14,451.0
Caroline,2016,FEMALE,30,0,30,144,204,90.0
Cassandra,2016,FEMALE,0,0,10,0,10,607.0
Cataleya,2016,FEMALE,0,0,14,0,14,451.0
Catalina,2016,FEMALE,0,0,17,0,17,383.0
Catherine,2016,FEMALE,32,0,0,38,70,200.0
Cecilia,2016,FEMALE,0,0,0,18,18,366.0
Celeste,2016,FEMALE,0,0,11,0,11,558.0
Celine,2016,FEMALE,36,0,39,48,123,129.0
Chana,2016,FEMALE,0,0,0,166,166,102.0
Chany,2016,FEMALE,0,0,0,45,45,254.0
Charlie,2016,FEMALE,0,0,0,18,18,366.0
Charlotte,2016,FEMALE,236,76,192,760,1264,11.0
Chava,2016,FEMALE,0,0,0,38,38,264.0
Chavy,2016,FEMALE,0,0,0,16,16,397.0
Chaya,2016,FEMALE,0,0,0,182,182,97.0
Chelsea,2016,FEMALE,63,69,81,0,213,87.0
Chloe,2016,FEMALE,448,204,300,288,1240,12.0
Christina,2016,FEMALE,54,39,0,30,123,129.0
Cindy,2016,FEMALE,17,0,0,0,17,383.0
Claire,2016,FEMALE,60,0,0,96,156,109.0
Clara,2016,FEMALE,28,0,0,80,108,146.0
Cleo,2016,FEMALE,0,0,0,10,10,607.0
Colette,2016,FEMALE,0,0,0,18,18,366.0
Cora,2016,FEMALE,0,0,0,26,26,304.0
Crystal,2016,FEMALE,34,0,20,0,54,232.0
Cynthia,2016,FEMALE,23,0,0,0,23,321.0
Dahlia,2016,FEMALE,0,0,0,13,13,488.0
Daisy,2016,FEMALE,0,0,16,0,16,397.0
Dakota,2016,FEMALE,0,20,0,0,20,342.0
Dalia,2016,FEMALE,0,0,0,11,11,558.0
Daniela,2016,FEMALE,0,0,52,0,52,236.0
Daniella,2016,FEMALE,0,0,38,44,82,174.0
Danielle,2016,FEMALE,0,26,0,20,46,251.0
Danna,2016,FEMALE,0,0,21,0,21,334.0
Daria,2016,FEMALE,0,0,0,11,11,558.0
Dayana,2016,FEMALE,0,0,11,0,11,558.0
Delilah,2016,FEMALE,0,0,52,20,72,195.0
Destiny,2016,FEMALE,0,40,40,0,80,181.0
Devora,2016,FEMALE,0,0,0,15,15,421.0
Devorah,2016,FEMALE,0,0,0,46,46,251.0
Diana,2016,FEMALE,0,0,62,48,110,142.0
Dina,2016,FEMALE,0,0,0,39,39,262.0
Diyora,2016,FEMALE,0,0,0,11,11,558.0
Dylan,2016,FEMALE,0,0,0,19,19,354.0
Eden,2016,FEMALE,0,24,0,28,52,236.0
Edith,2016,FEMALE,0,0,0,12,12,511.0
Egypt,2016,FEMALE,0,17,0,0,17,383.0
Eileen,2016,FEMALE,0,0,15,0,15,421.0
Elaine,2016,FEMALE,14,0,0,0,14,451.0
Eleanor,2016,FEMALE,24,0,0,106,130,123.0
Elena,2016,FEMALE,69,0,96,69,234,80.0
Eliana,2016,FEMALE,0,51,84,120,255,75.0
Elianna,2016,FEMALE,0,0,13,0,13,488.0
Elianny,2016,FEMALE,0,0,11,0,11,558.0
Elisa,2016,FEMALE,0,0,26,24,50,241.0
Elise,2016,FEMALE,0,0,0,17,17,383.0
Elisheva,2016,FEMALE,0,0,0,15,15,421.0
Eliza,2016,FEMALE,0,0,24,46,70,200.0
Elizabeth,2016,FEMALE,84,92,228,468,872,19.0
Ella,2016,FEMALE,168,48,108,456,780,22.0
Elle,2016,FEMALE,0,0,0,32,32,274.0
Ellie,2016,FEMALE,50,0,0,44,94,159.0
Eloise,2016,FEMALE,0,0,0,24,24,315.0
Elsa,2016,FEMALE,13,0,0,0,13,488.0
Emely,2016,FEMALE,0,0,33,0,33,273.0
Emerson,2016,FEMALE,0,0,0,24,24,315.0
Emilia,2016,FEMALE,42,0,90,198,330,61.0
Emily,2016,FEMALE,396,104,496,544,1540,7.0
Emma,2016,FEMALE,396,96,788,804,2084,3.0
Erika,2016,FEMALE,0,0,13,0,13,488.0
Esme,2016,FEMALE,0,0,0,14,14,451.0
Esmeralda,2016,FEMALE,0,0,15,0,15,421.0
Esther,2016,FEMALE,36,0,48,627,711,24.0
Esty,2016,FEMALE,0,0,0,32,32,274.0
Etty,2016,FEMALE,0,0,0,13,13,488.0
Eunice,2016,FEMALE,11,0,0,0,11,558.0
Eva,2016,FEMALE,104,52,108,272,536,36.0
Evangeline,2016,FEMALE,0,0,24,20,44,256.0
Eve,2016,FEMALE,0,0,0,17,17,383.0
Evelyn,2016,FEMALE,126,0,108,171,405,45.0
Everly,2016,FEMALE,0,0,0,12,12,511.0
Faiga,2016,FEMALE,0,0,0,22,22,327.0
Faigy,2016,FEMALE,0,0,0,91,91,163.0
Faith,2016,FEMALE,0,86,24,0,110,142.0
Fanta,2016,FEMALE,0,10,0,0,10,607.0
Farida,2016,FEMALE,0,0,0,11,11,558.0
Fatima,2016,FEMALE,136,144,48,48,376,52.0
Fatoumata,2016,FEMALE,0,48,0,0,48,246.0
Fernanda,2016,FEMALE,0,0,11,0,11,558.0
Finley,2016,FEMALE,0,0,0,10,10,607.0
Fiona,2016,FEMALE,70,0,0,88,158,108.0
Fradel,2016,FEMALE,0,0,0,15,15,421.0
Frady,2016,FEMALE,0,0,0,16,16,397.0
Fraidy,2016,FEMALE,0,0,0,27,27,296.0
Frances,2016,FEMALE,0,0,0,29,29,287.0
Francesca,2016,FEMALE,0,0,0,28,28,292.0
Freida,2016,FEMALE,0,0,0,13,13,488.0
Freya,2016,FEMALE,0,0,0,12,12,511.0
Frieda,2016,FEMALE,0,0,0,13,13,488.0
Frimet,2016,FEMALE,0,0,0,15,15,421.0
Gabriela,2016,FEMALE,0,0,86,36,122,132.0
Gabriella,2016,FEMALE,0,63,174,225,462,41.0
Gabrielle,2016,FEMALE,0,66,0,26,92,161.0
Gemma,2016,FEMALE,0,0,0,27,27,296.0
Genesis,2016,FEMALE,0,44,186,0,230,82.0
Genevieve,2016,FEMALE,0,0,0,16,16,397.0
Georgia,2016,FEMALE,0,0,0,20,20,342.0
Gia,2016,FEMALE,0,0,26,26,52,236.0
Gianna,2016,FEMALE,0,39,165,120,324,62.0
Giselle,2016,FEMALE,0,0,18,0,18,366.0
Gittel,2016,FEMALE,0,0,0,18,18,366.0
Gitty,2016,FEMALE,0,0,0,86,86,170.0
Giuliana,2016,FEMALE,0,0,0,25,25,308.0
Golda,2016,FEMALE,0,0,0,14,14,451.0
Goldie,2016,FEMALE,0,0,0,11,11,558.0
Goldy,2016,FEMALE,0,0,0,29,29,287.0
Grace,2016,FEMALE,216,112,176,336,840,20.0
Guadalupe,2016,FEMALE,0,0,16,0,16,397.0
Hadassah,2016,FEMALE,0,0,0,16,16,397.0
Hadley,2016,FEMALE,0,0,0,12,12,511.0
Hailey,2016,FEMALE,92,100,324,124,640,27.0
Hana,2016,FEMALE,30,0,0,34,64,213.0
Haniya,2016,FEMALE,13,0,0,0,13,488.0
Hanna,2016,FEMALE,32,0,0,32,64,213.0
Hannah,2016,FEMALE,224,68,60,304,656,26.0
Hareem,2016,FEMALE,11,0,0,0,11,558.0
Harley,2016,FEMALE,0,0,22,22,44,256.0
Harmony,2016,FEMALE,0,16,0,0,16,397.0
Harper,2016,FEMALE,57,36,0,201,294,68.0
Hazel,2016,FEMALE,30,0,39,105,174,101.0
Heaven,2016,FEMALE,0,46,32,0,78,184.0
Helen,2016,FEMALE,0,0,38,34,72,195.0
Henny,2016,FEMALE,0,0,0,15,15,421.0
Hinda,2016,FEMALE,0,0,0,12,12,511.0
Hindy,2016,FEMALE,0,0,0,25,25,308.0
Hoorain,2016,FEMALE,16,0,0,0,16,397.0
Hope,2016,FEMALE,0,10,0,0,10,607.0
Idy,2016,FEMALE,0,0,0,16,16,397.0
Imani,2016,FEMALE,0,21,0,0,21,334.0
Inaaya,2016,FEMALE,19,0,0,0,19,354.0
Inaya,2016,FEMALE,14,0,0,0,14,451.0
Irene,2016,FEMALE,20,0,0,0,20,342.0
Iris,2016,FEMALE,36,0,0,34,70,200.0
Isabel,2016,FEMALE,0,0,64,66,130,123.0
Isabela,2016,FEMALE,0,0,10,0,10,607.0
Isabella,2016,FEMALE,224,176,1104,324,1828,5.0
Isabelle,2016,FEMALE,80,64,60,156,360,54.0
Isla,2016,FEMALE,0,0,0,34,34,269.0
Itzel,2016,FEMALE,0,0,15,0,15,421.0
Ivanna,2016,FEMALE,0,0,10,0,10,607.0
Ivy,2016,FEMALE,42,0,0,34,76,188.0
Izabella,2016,FEMALE,0,0,15,0,15,421.0
Jacqueline,2016,FEMALE,42,0,45,36,123,129.0
Jada,2016,FEMALE,0,12,0,0,12,511.0
Jade,2016,FEMALE,0,30,96,0,126,126.0
Jaelyn,2016,FEMALE,0,0,12,0,12,511.0
Jaliyah,2016,FEMALE,0,10,0,0,10,607.0
Jamie,2016,FEMALE,0,0,12,0,12,511.0
Jane,2016,FEMALE,0,0,0,25,25,308.0
Janelle,2016,FEMALE,0,32,20,0,52,236.0
Janiyah,2016,FEMALE,0,12,0,0,12,511.0
Jannatul,2016,FEMALE,10,0,0,0,10,607.0
Jasmin,2016,FEMALE,0,0,10,0,10,607.0
Jasmine,2016,FEMALE,72,84,72,0,228,83.0
Jayla,2016,FEMALE,0,40,42,0,82,174.0
Jaylah,2016,FEMALE,0,0,14,0,14,451.0
Jayleen,2016,FEMALE,0,0,24,0,24,315.0
Jaylene,2016,FEMALE,0,0,17,0,17,383.0
Jaylin,2016,FEMALE,0,0,11,0,11,558.0
Jazlyn,2016,FEMALE,0,0,27,0,27,296.0
Jazmin,2016,FEMALE,0,0,19,0,19,354.0
Jenna,2016,FEMALE,0,0,0,11,11,558.0
Jennifer,2016,FEMALE,0,0,19,0,19,354.0
Jenny,2016,FEMALE,11,0,0,0,11,558.0
Jessica,2016,FEMALE,58,0,40,0,98,153.0
Jessie,2016,FEMALE,12,0,0,0,12,511.0
Jimena,2016,FEMALE,0,0,10,0,10,607.0
Joanna,2016,FEMALE,49,0,0,0,49,245.0
Jocelyn,2016,FEMALE,30,0,46,0,76,188.0
Jolie,2016,FEMALE,0,0,10,0,10,607.0
Jordyn,2016,FEMALE,0,22,0,0,22,327.0
Josephine,2016,FEMALE,0,0,24,88,112,140.0
Journee,2016,FEMALE,0,16,0,0,16,397.0
Journey,2016,FEMALE,0,12,0,0,12,511.0
Joy,2016,FEMALE,24,26,0,0,50,241.0
Joyce,2016,FEMALE,18,0,0,0,18,366.0
Judy,2016,FEMALE,0,0,0,14,14,451.0
Julia,2016,FEMALE,45,0,57,219,321,63.0
Juliana,2016,FEMALE,0,0,44,56,100,151.0
Julianna,2016,FEMALE,0,0,40,34,74,191.0
Julie,2016,FEMALE,0,0,0,12,12,511.0
Juliet,2016,FEMALE,0,0,44,66,110,142.0
Juliette,2016,FEMALE,0,0,98,78,176,100.0
June,2016,FEMALE,0,0,0,25,25,308.0
Juniper,2016,FEMALE,0,0,0,13,13,488.0
Kaia,2016,FEMALE,0,0,0,11,11,558.0
Kaitlyn,2016,FEMALE,34,0,54,0,88,167.0
Kali,2016,FEMALE,0,14,0,0,14,451.0
Kaliyah,2016,FEMALE,0,11,0,0,11,558.0
Kamila,2016,FEMALE,0,0,15,0,15,421.0
Karen,2016,FEMALE,24,0,32,0,56,229.0
Karla,2016,FEMALE,0,0,10,0,10,607.0
Kate,2016,FEMALE,0,0,20,30,50,241.0
Katerina,2016,FEMALE,0,0,0,10,10,607.0
Katherine,2016,FEMALE,72,0,138,111,321,63.0
Katie,2016,FEMALE,18,0,0,0,18,366.0
Kayla,2016,FEMALE,104,140,168,120,532,37.0
Kaylani,2016,FEMALE,0,0,10,0,10,607.0
Kaylee,2016,FEMALE,63,60,192,0,315,65.0
Kaylie,2016,FEMALE,0,0,12,0,12,511.0
Keily,2016,FEMALE,0,0,17,0,17,383.0
Keira,2016,FEMALE,20,0,0,40,60,221.0
Kelly,2016,FEMALE,32,0,30,0,62,218.0
Kelsey,2016,FEMALE,0,0,11,0,11,558.0
Kendra,2016,FEMALE,0,0,13,0,13,488.0
Kennedy,2016,FEMALE,0,21,0,0,21,334.0
Keyla,2016,FEMALE,0,0,29,0,29,287.0
Khadija,2016,FEMALE,0,10,0,0,10,607.0
Khaleesi,2016,FEMALE,0,0,12,0,12,511.0
Khloe,2016,FEMALE,0,64,70,0,134,121.0
Kiara,2016,FEMALE,0,34,72,0,106,149.0
Kimberly,2016,FEMALE,0,0,81,0,81,180.0
Kimora,2016,FEMALE,0,20,0,0,20,342.0
Kira,2016,FEMALE,22,0,0,42,64,213.0
Kori,2016,FEMALE,0,10,0,0,10,607.0
Kylie,2016,FEMALE,0,68,92,0,160,104.0
Laila,2016,FEMALE,0,96,51,66,213,87.0
Lana,2016,FEMALE,0,0,0,16,16,397.0
Lara,2016,FEMALE,0,0,0,23,23,321.0
Laura,2016,FEMALE,30,0,39,36,105,150.0
Lauren,2016,FEMALE,0,78,60,39,177,98.0
Layan,2016,FEMALE,0,0,0,15,15,421.0
Layla,2016,FEMALE,44,100,228,232,604,29.0
Lea,2016,FEMALE,0,0,0,17,17,383.0
Leah,2016,FEMALE,80,128,464,712,1384,8.0
Leanna,2016,FEMALE,14,0,0,0,14,451.0
Leela,2016,FEMALE,10,0,0,0,10,607.0
Leia,2016,FEMALE,0,0,14,0,14,451.0
Leila,2016,FEMALE,0,30,45,72,147,112.0
Leilani,2016,FEMALE,0,38,44,0,82,174.0
Leilany,2016,FEMALE,0,0,11,0,11,558.0
Lena,2016,FEMALE,0,0,0,16,16,397.0
Leslie,2016,FEMALE,0,0,32,0,32,274.0
Lesly,2016,FEMALE,0,0,12,0,12,511.0
Leyla,2016,FEMALE,0,0,0,11,11,558.0
Lia,2016,FEMALE,30,0,75,39,144,113.0
Liana,2016,FEMALE,0,0,32,38,70,200.0
Liba,2016,FEMALE,0,0,0,12,12,511.0
Libby,2016,FEMALE,0,0,0,32,32,274.0
Lila,2016,FEMALE,0,0,0,45,45,254.0
Lilah,2016,FEMALE,0,0,0,12,12,511.0
Liliana,2016,FEMALE,0,0,44,80,124,127.0
Lillian,2016,FEMALE,33,0,33,111,177,98.0
Lilliana,2016,FEMALE,0,0,0,10,10,607.0
Lilly,2016,FEMALE,0,0,0,11,11,558.0
Lily,2016,FEMALE,54,0,54,237,345,58.0
Lina,2016,FEMALE,0,0,0,10,10,607.0
Liora,2016,FEMALE,0,0,0,12,12,511.0
Liv,2016,FEMALE,0,0,0,14,14,451.0
Livia,2016,FEMALE,20,0,0,28,48,246.0
Lizbeth,2016,FEMALE,0,0,13,0,13,488.0
Logan,2016,FEMALE,0,0,0,10,10,607.0
Lola,2016,FEMALE,0,0,0,17,17,383.0
London,2016,FEMALE,0,82,42,0,124,127.0
Londyn,2016,FEMALE,0,14,0,0,14,451.0
Louisa,2016,FEMALE,0,0,0,14,14,451.0
Louise,2016,FEMALE,0,0,0,16,16,397.0
Lucia,2016,FEMALE,0,0,34,64,98,153.0
Luciana,2016,FEMALE,0,0,14,0,14,451.0
Lucy,2016,FEMALE,26,0,0,88,114,138.0
Luna,2016,FEMALE,36,0,171,63,270,72.0
Luz,2016,FEMALE,0,0,11,0,11,558.0
Lydia,2016,FEMALE,28,0,0,38,66,209.0
Lyla,2016,FEMALE,0,0,0,26,26,304.0
Lyric,2016,FEMALE,0,18,0,0,18,366.0
Mackenzie,2016,FEMALE,0,39,42,72,153,110.0
Madeleine,2016,FEMALE,0,0,0,19,19,354.0
Madeline,2016,FEMALE,0,0,22,96,118,136.0
Madelyn,2016,FEMALE,0,0,34,52,86,170.0
Madina,2016,FEMALE,0,0,0,11,11,558.0
Madison,2016,FEMALE,92,416,460,316,1284,10.0
Maeve,2016,FEMALE,0,0,0,28,28,292.0
Maggie,2016,FEMALE,0,0,0,10,10,607.0
Mahnoor,2016,FEMALE,11,0,0,0,11,558.0
Maia,2016,FEMALE,0,0,42,24,66,209.0
Maimouna,2016,FEMALE,0,10,0,0,10,607.0
Makayla,2016,FEMALE,0,64,24,0,88,167.0
Malak,2016,FEMALE,0,0,0,14,14,451.0
Malaysia,2016,FEMALE,0,11,0,0,11,558.0
Malia,2016,FEMALE,0,76,22,0,98,153.0
Malika,2016,FEMALE,0,0,0,15,15,421.0
Maliyah,2016,FEMALE,0,15,0,0,15,421.0
Malka,2016,FEMALE,0,0,0,95,95,158.0
Malky,2016,FEMALE,0,0,0,87,87,169.0
Manha,2016,FEMALE,16,0,0,0,16,397.0
Margaret,2016,FEMALE,0,0,0,27,27,296.0
Margaux,2016,FEMALE,0,0,0,10,10,607.0
Margot,2016,FEMALE,0,0,0,20,20,342.0
Maria,2016,FEMALE,0,0,120,94,214,86.0
Mariah,2016,FEMALE,0,42,36,0,78,184.0
Mariam,2016,FEMALE,30,93,0,66,189,95.0
Mariama,2016,FEMALE,0,30,0,0,30,283.0
Mariana,2016,FEMALE,0,0,27,0,27,296.0
Marley,2016,FEMALE,0,12,0,0,12,511.0
Marlowe,2016,FEMALE,0,0,0,10,10,607.0
Mary,2016,FEMALE,0,0,0,23,23,321.0
Maryam,2016,FEMALE,52,0,0,40,92,161.0
Matilda,2016,FEMALE,0,0,0,16,16,397.0
Maya,2016,FEMALE,156,80,148,548,932,17.0
McKenzie,2016,FEMALE,0,14,0,0,14,451.0
Mckenzie,2016,FEMALE,0,11,0,0,11,558.0
Meera,2016,FEMALE,12,0,0,0,12,511.0
Megan,2016,FEMALE,0,0,13,0,13,488.0
Melanie,2016,FEMALE,0,22,174,0,196,94.0
Melany,2016,FEMALE,0,0,22,0,22,327.0
Melissa,2016,FEMALE,0,0,32,0,32,274.0
Melody,2016,FEMALE,44,0,24,0,68,205.0
Mia,2016,FEMALE,316,148,912,468,1844,4.0
Miah,2016,FEMALE,0,0,13,0,13,488.0
Michal,2016,FEMALE,0,0,0,10,10,607.0
Michelle,2016,FEMALE,92,76,116,116,400,47.0
Mikaela,2016,FEMALE,0,0,13,0,13,488.0
Mikayla,2016,FEMALE,0,10,0,0,10,607.0
Mila,2016,FEMALE,68,40,192,264,564,31.0
Milan,2016,FEMALE,0,10,0,0,10,607.0
Milana,2016,FEMALE,0,0,0,19,19,354.0
Milani,2016,FEMALE,0,12,0,0,12,511.0
Mina,2016,FEMALE,14,0,0,0,14,451.0
Mindy,2016,FEMALE,0,0,0,21,21,334.0
Mira,2016,FEMALE,20,0,0,48,68,205.0
Miracle,2016,FEMALE,0,25,0,0,25,308.0
Miranda,2016,FEMALE,22,0,36,0,58,225.0
Mirel,2016,FEMALE,0,0,0,14,14,451.0
Miri,2016,FEMALE,0,0,0,12,12,511.0
Miriam,2016,FEMALE,0,0,0,159,159,105.0
Molly,2016,FEMALE,0,0,0,31,31,280.0
Montserrat,2016,FEMALE,0,0,11,0,11,558.0
Morgan,2016,FEMALE,0,56,0,30,86,170.0
Mya,2016,FEMALE,0,34,56,0,90,164.0
Myra,2016,FEMALE,19,0,0,0,19,354.0
Nadia,2016,FEMALE,0,0,0,14,14,451.0
Nala,2016,FEMALE,0,14,0,0,14,451.0
Nalani,2016,FEMALE,0,11,0,0,11,558.0
Naomi,2016,FEMALE,0,96,84,159,339,59.0
Nashla,2016,FEMALE,0,0,14,0,14,451.0
Natalia,2016,FEMALE,0,0,72,50,122,132.0
Natalie,2016,FEMALE,72,0,96,129,297,67.0
Natasha,2016,FEMALE,0,0,15,0,15,421.0
Nathalia,2016,FEMALE,0,0,15,0,15,421.0
Nathalie,2016,FEMALE,0,0,11,0,11,558.0
Nathaly,2016,FEMALE,0,0,14,0,14,451.0
Nayeli,2016,FEMALE,0,0,10,0,10,607.0
Nechama,2016,FEMALE,0,0,0,31,31,280.0
Nevaeh,2016,FEMALE,0,35,0,0,35,268.0
Nia,2016,FEMALE,0,68,22,0,90,164.0
Nicole,2016,FEMALE,51,0,153,105,309,66.0
Nicolette,2016,FEMALE,0,0,0,10,10,607.0
Nina,2016,FEMALE,36,0,0,74,110,142.0
Noa,2016,FEMALE,0,0,0,36,36,267.0
Noemi,2016,FEMALE,0,0,10,0,10,607.0
Noor,2016,FEMALE,22,0,0,40,62,218.0
Nora,2016,FEMALE,22,0,0,92,114,138.0
Nova,2016,FEMALE,0,28,40,0,68,205.0
Nyla,2016,FEMALE,0,56,26,0,82,174.0
Nylah,2016,FEMALE,0,48,26,0,74,191.0
Olive,2016,FEMALE,0,0,0,17,17,383.0
Olivia,2016,FEMALE,688,196,432,920,2236,1.0
Oumou,2016,FEMALE,0,12,0,0,12,511.0
Paige,2016,FEMALE,0,90,33,42,165,103.0
Paris,2016,FEMALE,0,44,20,0,64,213.0
Pearl,2016,FEMALE,0,0,0,38,38,264.0
Penelope,2016,FEMALE,45,0,204,186,435,43.0
Perel,2016,FEMALE,0,0,0,14,14,451.0
Perl,2016,FEMALE,0,0,0,19,19,354.0
Pessy,2016,FEMALE,0,0,0,22,22,327.0
Peyton,2016,FEMALE,0,92,20,0,112,140.0
Phoebe,2016,FEMALE,54,0,0,40,94,159.0
Poppy,2016,FEMALE,0,0,0,10,10,607.0
Princess,2016,FEMALE,0,11,0,0,11,558.0
Queena,2016,FEMALE,16,0,0,0,16,397.0
Queenie,2016,FEMALE,20,0,0,0,20,342.0
Quinn,2016,FEMALE,0,0,0,29,29,287.0
Rachel,2016,FEMALE,84,0,39,663,786,21.0
Raizel,2016,FEMALE,0,0,0,18,18,366.0
Raizy,2016,FEMALE,0,0,0,55,55,230.0
Raquel,2016,FEMALE,0,0,0,15,15,421.0
Reagan,2016,FEMALE,0,0,0,14,14,451.0
Rebecca,2016,FEMALE,0,0,0,43,43,258.0
Reem,2016,FEMALE,0,0,0,10,10,607.0
Reese,2016,FEMALE,0,0,0,16,16,397.0
Reign,2016,FEMALE,0,11,0,0,11,558.0
Rifka,2016,FEMALE,0,0,0,14,14,451.0
Rifky,2016,FEMALE,0,0,0,13,13,488.0
Riley,2016,FEMALE,96,260,176,220,752,23.0
Riva,2016,FEMALE,0,0,0,10,10,607.0
Rivka,2016,FEMALE,0,0,0,127,127,125.0
Rivkah,2016,FEMALE,0,0,0,14,14,451.0
Rivky,2016,FEMALE,0,0,0,61,61,220.0
Rochel,2016,FEMALE,0,0,0,29,29,287.0
Rose,2016,FEMALE,0,0,40,98,138,117.0
Roselyn,2016,FEMALE,0,0,12,0,12,511.0
Rosemary,2016,FEMALE,0,0,11,0,11,558.0
Ruby,2016,FEMALE,0,0,48,92,140,116.0
Ruchy,2016,FEMALE,0,0,0,17,17,383.0
Ruth,2016,FEMALE,0,0,24,34,58,225.0
Ryan,2016,FEMALE,0,0,0,13,13,488.0
Rylee,2016,FEMALE,0,11,0,0,11,558.0
Sabina,2016,FEMALE,0,0,0,15,15,421.0
Sabrina,2016,FEMALE,0,0,34,38,72,195.0
Sadie,2016,FEMALE,0,0,26,82,108,146.0
Sage,2016,FEMALE,0,15,0,0,15,421.0
Salma,2016,FEMALE,0,0,0,18,18,366.0
Samantha,2016,FEMALE,42,0,237,123,402,46.0
Samara,2016,FEMALE,0,0,17,0,17,383.0
Samira,2016,FEMALE,0,0,0,21,21,334.0
Sanaa,2016,FEMALE,0,10,0,0,10,607.0
Sanai,2016,FEMALE,0,10,0,0,10,607.0
Saniyah,2016,FEMALE,0,10,0,0,10,607.0
Sara,2016,FEMALE,48,0,75,444,567,30.0
Sarah,2016,FEMALE,228,100,196,808,1332,9.0
Sarai,2016,FEMALE,0,28,52,0,80,181.0
Sasha,2016,FEMALE,0,36,48,60,144,113.0
Savannah,2016,FEMALE,48,216,140,100,504,38.0
Scarlet,2016,FEMALE,0,0,11,0,11,558.0
Scarlett,2016,FEMALE,33,0,282,123,438,42.0
Selena,2016,FEMALE,0,0,20,0,20,342.0
Selina,2016,FEMALE,12,0,0,0,12,511.0
Serena,2016,FEMALE,30,0,0,30,60,221.0
Serenity,2016,FEMALE,0,66,66,0,132,122.0
Shaina,2016,FEMALE,0,0,0,16,16,397.0
Shaindy,2016,FEMALE,0,0,0,47,47,250.0
Sharon,2016,FEMALE,13,0,0,0,13,488.0
Shea,2016,FEMALE,0,0,0,13,13,488.0
Sherlyn,2016,FEMALE,0,0,20,0,20,342.0
Shevy,2016,FEMALE,0,0,0,12,12,511.0
Shifra,2016,FEMALE,0,0,0,15,15,421.0
Shira,2016,FEMALE,0,0,0,19,19,354.0
Shirley,2016,FEMALE,0,0,10,0,10,607.0
Shoshana,2016,FEMALE,0,0,0,28,28,292.0
Siena,2016,FEMALE,0,0,0,15,15,421.0
Sienna,2016,FEMALE,0,0,30,122,152,111.0
Sima,2016,FEMALE,0,0,0,11,11,558.0
Simone,2016,FEMALE,0,0,0,13,13,488.0
Skye,2016,FEMALE,0,10,0,0,10,607.0
Skyla,2016,FEMALE,0,32,28,0,60,221.0
Skylar,2016,FEMALE,0,204,90,63,357,55.0
Skyler,2016,FEMALE,0,0,12,0,12,511.0
Sloane,2016,FEMALE,0,0,0,41,41,261.0
Sofia,2016,FEMALE,60,0,537,330,927,18.0
Sonia,2016,FEMALE,0,0,0,10,10,607.0
Sophia,2016,FEMALE,416,160,1044,576,2196,2.0
Sophie,2016,FEMALE,84,0,66,186,336,60.0
Stella,2016,FEMALE,36,0,57,201,294,68.0
Stephanie,2016,FEMALE,38,0,62,0,100,151.0
Summer,2016,FEMALE,20,0,0,38,58,225.0
Suri,2016,FEMALE,0,0,0,10,10,607.0
Sury,2016,FEMALE,0,0,0,27,27,296.0
Sydney,2016,FEMALE,0,40,0,50,90,164.0
Syeda,2016,FEMALE,10,0,0,0,10,607.0
Sylvia,2016,FEMALE,22,0,0,20,42,259.0
Sylvie,2016,FEMALE,0,0,0,16,16,397.0
Talia,2016,FEMALE,0,42,0,94,136,119.0
Tamar,2016,FEMALE,0,0,0,11,11,558.0
Tamara,2016,FEMALE,0,0,0,10,10,607.0
Tamia,2016,FEMALE,0,11,0,0,11,558.0
Taylor,2016,FEMALE,33,111,0,54,198,93.0
Teagan,2016,FEMALE,0,0,0,13,13,488.0
Tenzin,2016,FEMALE,20,0,0,0,20,342.0
Tessa,2016,FEMALE,0,0,0,12,12,511.0
Tiana,2016,FEMALE,0,10,0,0,10,607.0
Tianna,2016,FEMALE,0,12,0,0,12,511.0
Tiffany,2016,FEMALE,50,0,24,0,74,191.0
Toba,2016,FEMALE,0,0,0,12,12,511.0
Toby,2016,FEMALE,0,0,0,54,54,232.0
Tori,2016,FEMALE,0,18,0,0,18,366.0
Tova,2016,FEMALE,0,0,0,13,13,488.0
Trany,2016,FEMALE,0,0,0,12,12,511.0
Trinity,2016,FEMALE,0,44,20,0,64,213.0
Tzipora,2016,FEMALE,0,0,0,16,16,397.0
Tziporah,2016,FEMALE,0,0,0,14,14,451.0
Valentina,2016,FEMALE,0,0,238,108,346,57.0
Valeria,2016,FEMALE,0,0,34,0,34,269.0
Valerie,2016,FEMALE,36,0,183,33,252,76.0
Valery,2016,FEMALE,0,0,16,0,16,397.0
Vanessa,2016,FEMALE,0,0,48,20,68,205.0
Vera,2016,FEMALE,0,0,0,15,15,421.0
Veronica,2016,FEMALE,0,0,20,32,52,236.0
Vicky,2016,FEMALE,14,0,0,0,14,451.0
Victoria,2016,FEMALE,128,120,464,304,1016,14.0
Vienna,2016,FEMALE,0,0,0,13,13,488.0
Violet,2016,FEMALE,0,30,69,171,270,72.0
Vivian,2016,FEMALE,60,0,0,60,120,134.0
Vivienne,2016,FEMALE,0,0,0,34,34,269.0
Wendy,2016,FEMALE,0,0,10,0,10,607.0
Willa,2016,FEMALE,0,0,0,28,28,292.0
Willow,2016,FEMALE,0,0,0,15,15,421.0
Winnie,2016,FEMALE,14,0,0,0,14,451.0
Ximena,2016,FEMALE,0,0,30,0,30,283.0
Yael,2016,FEMALE,0,0,0,20,20,342.0
Yamileth,2016,FEMALE,0,0,11,0,11,558.0
Yaretzi,2016,FEMALE,0,0,16,0,16,397.0
Yasmin,2016,FEMALE,0,0,0,10,10,607.0
Yehudis,2016,FEMALE,0,0,0,16,16,397.0
Yides,2016,FEMALE,0,0,0,25,25,308.0
Yitty,2016,FEMALE,0,0,0,58,58,225.0
Yocheved,2016,FEMALE,0,0,0,38,38,264.0
Yuna,2016,FEMALE,11,0,0,0,11,558.0
Zahra,2016,FEMALE,22,20,0,0,42,259.0
Zainab,2016,FEMALE,56,0,0,20,76,188.0
Zara,2016,FEMALE,104,56,44,44,248,78.0
Zariah,2016,FEMALE,0,15,0,0,15,421.0
Zelda,2016,FEMALE,0,0,0,10,10,607.0
Zissy,2016,FEMALE,0,0,0,15,15,421.0
Zoe,2016,FEMALE,124,180,332,324,960,16.0
Zoey,2016,FEMALE,116,136,220,72,544,33.0
Zuri,2016,FEMALE,0,30,0,0,30,283.0
Aahil,2016,MALE,11,0,0,0,11,520.0
Aarav,2016,MALE,15,0,0,0,15,416.0
Aaron,2016,MALE,228,156,564,220,1168,26.0
Aaryan,2016,MALE,13,0,0,0,13,460.0
Aayan,2016,MALE,14,0,0,0,14,434.0
Abdiel,2016,MALE,0,0,16,0,16,403.0
Abdoul,2016,MALE,0,11,0,0,11,520.0
Abdul,2016,MALE,14,0,0,0,14,434.0
Abdullah,2016,MALE,72,0,0,38,110,156.0
Abel,2016,MALE,0,0,38,0,38,260.0
Abraham,2016,MALE,0,30,126,489,645,48.0
Adam,2016,MALE,112,84,192,712,1100,29.0
Aden,2016,MALE,12,0,0,0,12,485.0
Adiel,2016,MALE,0,0,12,0,12,485.0
Adonis,2016,MALE,0,62,32,0,94,168.0
Adrian,2016,MALE,80,68,540,188,876,39.0
Adriel,2016,MALE,0,0,37,0,37,265.0
Adyan,2016,MALE,13,0,0,0,13,460.0
Aharon,2016,MALE,0,0,0,17,17,395.0
Ahmad,2016,MALE,24,0,0,22,46,247.0
Ahmed,2016,MALE,28,0,0,66,94,168.0
Ahnaf,2016,MALE,15,0,0,0,15,416.0
Ahron,2016,MALE,0,0,0,11,11,520.0
Aidan,2016,MALE,100,56,84,152,392,77.0
Aiden,2016,MALE,532,548,768,268,2116,6.0
Akiva,2016,MALE,0,0,0,21,21,347.0
Alan,2016,MALE,75,0,174,81,330,88.0
Albert,2016,MALE,33,0,30,60,123,151.0
Alejandro,2016,MALE,0,0,52,0,52,237.0
Alessandro,2016,MALE,0,0,12,0,12,485.0
Alex,2016,MALE,148,56,212,104,520,60.0
Alexander,2016,MALE,212,136,676,844,1868,12.0
Alexis,2016,MALE,0,0,33,0,33,277.0
Ali,2016,MALE,30,30,0,159,219,119.0
Allan,2016,MALE,0,0,11,0,11,520.0
Allen,2016,MALE,40,0,46,0,86,181.0
Alpha,2016,MALE,0,16,0,0,16,403.0
Alston,2016,MALE,10,0,0,0,10,556.0
Alvin,2016,MALE,36,0,0,0,36,270.0
Amadou,2016,MALE,0,12,0,0,12,485.0
Amari,2016,MALE,0,37,0,0,37,265.0
Ameer,2016,MALE,0,20,0,24,44,249.0
Amir,2016,MALE,0,285,57,87,429,71.0
Anas,2016,MALE,0,0,0,16,16,403.0
Anderson,2016,MALE,0,0,20,0,20,356.0
Andre,2016,MALE,0,30,30,0,60,216.0
Andres,2016,MALE,0,0,24,0,24,324.0
Andrew,2016,MALE,180,84,300,408,972,35.0
Andy,2016,MALE,64,0,56,0,120,152.0
Angel,2016,MALE,0,0,187,0,187,125.0
Angelo,2016,MALE,0,0,30,32,62,209.0
Anson,2016,MALE,18,0,0,0,18,382.0
Anthony,2016,MALE,100,136,520,400,1156,27.0
Antonio,2016,MALE,0,0,20,60,80,190.0
Arham,2016,MALE,27,0,0,0,27,303.0
Ari,2016,MALE,0,0,0,49,49,241.0
Ariel,2016,MALE,0,0,32,48,80,190.0
Arjun,2016,MALE,20,0,0,0,20,356.0
Arlo,2016,MALE,0,0,0,20,20,356.0
Armaan,2016,MALE,13,0,0,0,13,460.0
Armani,2016,MALE,0,0,13,0,13,460.0
Aron,2016,MALE,0,0,0,61,61,215.0
Arthur,2016,MALE,0,0,0,34,34,273.0
Arturo,2016,MALE,0,0,10,0,10,556.0
Aryan,2016,MALE,22,0,0,0,22,337.0
Aryeh,2016,MALE,0,0,0,30,30,287.0
Asher,2016,MALE,44,56,40,272,412,73.0
Ashton,2016,MALE,24,70,0,0,94,168.0
August,2016,MALE,0,0,24,52,76,197.0
Augustus,2016,MALE,0,0,0,10,10,556.0
Austin,2016,MALE,276,112,196,96,680,45.0
Avery,2016,MALE,0,84,63,42,189,123.0
Avi,2016,MALE,0,0,0,19,19,369.0
Aviel,2016,MALE,0,0,0,10,10,556.0
Avraham,2016,MALE,0,0,0,47,47,246.0
Avrohom,2016,MALE,0,0,0,22,22,337.0
Avrum,2016,MALE,0,0,0,12,12,485.0
Axel,2016,MALE,0,0,126,30,156,136.0
Ayaan,2016,MALE,33,0,0,0,33,277.0
Ayan,2016,MALE,18,0,0,0,18,382.0
Ayden,2016,MALE,92,188,296,48,624,51.0
Aydin,2016,MALE,11,0,0,0,11,520.0
Azaan,2016,MALE,13,0,0,0,13,460.0
Baruch,2016,MALE,0,0,0,20,20,356.0
Beckett,2016,MALE,0,0,0,14,14,434.0
Ben,2016,MALE,0,0,0,29,29,291.0
Benjamin,2016,MALE,220,80,332,876,1508,19.0
Bennett,2016,MALE,0,0,0,19,19,369.0
Benson,2016,MALE,18,0,0,0,18,382.0
Benzion,2016,MALE,0,0,0,15,15,416.0
Berl,2016,MALE,0,0,0,10,10,556.0
Binyamin,2016,MALE,0,0,0,15,15,416.0
Blake,2016,MALE,0,24,0,30,54,231.0
Bodhi,2016,MALE,0,0,0,15,15,416.0
Boruch,2016,MALE,0,0,0,13,13,460.0
Bradley,2016,MALE,0,0,58,20,78,194.0
Brandon,2016,MALE,148,124,296,84,652,47.0
Brayan,2016,MALE,0,0,15,0,15,416.0
Brayden,2016,MALE,52,40,120,52,264,106.0
Brendan,2016,MALE,0,0,0,12,12,485.0
Brian,2016,MALE,114,0,66,48,228,114.0
Brody,2016,MALE,0,0,0,14,14,434.0
Bryan,2016,MALE,51,36,138,0,225,117.0
Bryce,2016,MALE,0,58,40,0,98,162.0
Bryson,2016,MALE,0,62,34,0,96,166.0
Byron,2016,MALE,0,0,12,0,12,485.0
Caden,2016,MALE,18,0,0,0,18,382.0
Caiden,2016,MALE,0,22,20,0,42,252.0
Cairo,2016,MALE,0,12,0,0,12,485.0
Caleb,2016,MALE,88,160,140,88,476,63.0
Calvin,2016,MALE,28,0,0,30,58,219.0
Camden,2016,MALE,0,0,0,10,10,556.0
Cameron,2016,MALE,52,232,96,96,476,63.0
Camren,2016,MALE,0,10,0,0,10,556.0
Carlos,2016,MALE,0,0,78,0,78,194.0
Carson,2016,MALE,15,0,0,0,15,416.0
Carter,2016,MALE,48,320,96,96,560,57.0
Cayden,2016,MALE,20,20,0,0,40,256.0
Cesar,2016,MALE,0,0,20,0,20,356.0
Chaim,2016,MALE,0,0,0,140,140,142.0
Chance,2016,MALE,0,27,0,0,27,303.0
Charles,2016,MALE,68,48,64,436,616,53.0
Charlie,2016,MALE,0,0,0,26,26,313.0
Chase,2016,MALE,0,195,66,93,354,86.0
Cheskel,2016,MALE,0,0,0,20,20,356.0
Chesky,2016,MALE,0,0,0,15,15,416.0
Chris,2016,MALE,28,0,34,0,62,209.0
Christian,2016,MALE,84,244,304,168,800,40.0
Christopher,2016,MALE,88,176,652,284,1200,22.0
Cody,2016,MALE,11,0,0,0,11,520.0
Cole,2016,MALE,0,0,0,38,38,260.0
Colin,2016,MALE,0,0,0,30,30,287.0
Colton,2016,MALE,0,0,0,10,10,556.0
Connor,2016,MALE,72,33,0,171,276,102.0
Conor,2016,MALE,0,0,0,24,24,324.0
Cooper,2016,MALE,0,0,0,29,29,291.0
Cristian,2016,MALE,0,0,26,0,26,313.0
Cyrus,2016,MALE,26,0,0,24,50,239.0
Damari,2016,MALE,0,10,0,0,10,556.0
Damian,2016,MALE,0,0,100,30,130,147.0
Damien,2016,MALE,0,0,19,0,19,369.0
Damon,2016,MALE,12,0,0,0,12,485.0
Daniel,2016,MALE,324,208,752,784,2068,7.0
Dante,2016,MALE,0,0,10,0,10,556.0
Dariel,2016,MALE,0,0,20,0,20,356.0
Darius,2016,MALE,0,13,0,0,13,460.0
Darren,2016,MALE,32,0,0,0,32,281.0
Darwin,2016,MALE,0,0,10,0,10,556.0
David,2016,MALE,104,264,516,1020,1904,11.0
Dean,2016,MALE,0,0,0,34,34,273.0
Declan,2016,MALE,0,0,0,26,26,313.0
Derek,2016,MALE,48,0,76,0,124,148.0
Derrick,2016,MALE,0,11,0,0,11,520.0
Desmond,2016,MALE,0,0,0,12,12,485.0
Devin,2016,MALE,10,0,0,0,10,556.0
Diego,2016,MALE,0,0,69,0,69,200.0
Dillon,2016,MALE,0,0,0,10,10,556.0
Dominic,2016,MALE,0,0,52,42,94,168.0
Dominick,2016,MALE,0,0,34,26,60,216.0
Donovan,2016,MALE,0,0,0,15,15,416.0
Dov,2016,MALE,0,0,0,51,51,238.0
Dovid,2016,MALE,0,0,0,38,38,260.0
Dylan,2016,MALE,184,132,1248,404,1968,10.0
Ean,2016,MALE,0,0,17,0,17,395.0
Eason,2016,MALE,35,0,0,0,35,272.0
Eden,2016,MALE,12,0,0,0,12,485.0
Edgar,2016,MALE,0,0,15,0,15,416.0
Edison,2016,MALE,28,0,20,0,48,243.0
Eduardo,2016,MALE,0,0,21,0,21,347.0
Edward,2016,MALE,33,0,108,141,282,100.0
Edwin,2016,MALE,22,0,64,0,86,181.0
Efraim,2016,MALE,0,0,0,18,18,382.0
Eitan,2016,MALE,0,0,0,20,20,356.0
Elan,2016,MALE,0,0,0,10,10,556.0
Eli,2016,MALE,60,88,132,468,748,43.0
Eliam,2016,MALE,0,0,10,0,10,556.0
Elian,2016,MALE,0,0,27,0,27,303.0
Elias,2016,MALE,0,51,219,96,366,82.0
Eliel,2016,MALE,0,0,12,0,12,485.0
Eliezer,2016,MALE,0,0,0,41,41,255.0
Elijah,2016,MALE,76,464,360,132,1032,33.0
Elimelech,2016,MALE,0,0,0,18,18,382.0
Eliyahu,2016,MALE,0,0,0,29,29,291.0
Elliot,2016,MALE,0,0,22,62,84,184.0
Elliott,2016,MALE,0,0,0,25,25,319.0
Ellis,2016,MALE,0,0,0,21,21,347.0
Elvis,2016,MALE,12,0,0,0,12,485.0
Elya,2016,MALE,0,0,0,13,13,460.0
Emanuel,2016,MALE,0,0,25,0,25,319.0
Emilio,2016,MALE,0,0,24,0,24,324.0
Emmanuel,2016,MALE,0,58,112,0,170,128.0
Emmett,2016,MALE,0,0,0,24,24,324.0
Enrique,2016,MALE,0,0,12,0,12,485.0
Enzo,2016,MALE,0,0,30,24,54,231.0
Eric,2016,MALE,201,0,66,60,327,90.0
Erick,2016,MALE,0,0,63,0,63,208.0
Ethan,2016,MALE,772,428,1000,532,2732,3.0
Evan,2016,MALE,231,0,120,114,465,66.0
Everett,2016,MALE,0,0,0,19,19,369.0
Eyad,2016,MALE,0,0,0,10,10,556.0
Ezekiel,2016,MALE,0,28,28,0,56,224.0
Ezequiel,2016,MALE,0,0,11,0,11,520.0
Ezra,2016,MALE,0,60,57,162,279,101.0
Fabian,2016,MALE,0,0,10,0,10,556.0
Farhan,2016,MALE,11,0,0,0,11,520.0
Felipe,2016,MALE,0,0,12,0,12,485.0
Felix,2016,MALE,48,0,30,69,147,139.0
Fernando,2016,MALE,0,0,13,0,13,460.0
Finn,2016,MALE,0,0,0,34,34,273.0
Fishel,2016,MALE,0,0,0,12,12,485.0
Francesco,2016,MALE,0,0,0,16,16,403.0
Francis,2016,MALE,0,0,0,13,13,460.0
Francisco,2016,MALE,0,0,21,0,21,347.0
Frank,2016,MALE,0,0,24,58,82,188.0
Franklin,2016,MALE,0,0,13,0,13,460.0
Frederick,2016,MALE,0,0,0,14,14,434.0
Gabriel,2016,MALE,72,124,460,496,1152,28.0
Gael,2016,MALE,0,0,55,0,55,229.0
Gavin,2016,MALE,96,0,30,105,231,113.0
Gavriel,2016,MALE,0,0,0,20,20,356.0
George,2016,MALE,76,44,76,304,500,61.0
Gianluca,2016,MALE,0,0,0,11,11,520.0
Giovanni,2016,MALE,0,45,78,75,198,122.0
Giuseppe,2016,MALE,0,0,0,12,12,485.0
Graham,2016,MALE,0,0,0,26,26,313.0
Grant,2016,MALE,0,0,0,22,22,337.0
Grayson,2016,MALE,40,64,76,148,328,89.0
Gregory,2016,MALE,0,0,0,11,11,520.0
Greyson,2016,MALE,0,36,63,39,138,144.0
Griffin,2016,MALE,0,0,0,14,14,434.0
Hamza,2016,MALE,38,0,0,50,88,176.0
Harrison,2016,MALE,54,0,36,138,228,114.0
Harry,2016,MALE,0,0,0,14,14,434.0
Hashim,2016,MALE,13,0,0,0,13,460.0
Hayden,2016,MALE,11,0,0,0,11,520.0
Hector,2016,MALE,0,0,22,0,22,337.0
Henry,2016,MALE,224,40,128,784,1176,25.0
Herman,2016,MALE,0,0,0,10,10,556.0
Hersh,2016,MALE,0,0,0,17,17,395.0
Hershel,2016,MALE,0,0,0,24,24,324.0
Hershy,2016,MALE,0,0,0,28,28,297.0
Hudson,2016,MALE,60,0,36,189,285,99.0
Hugo,2016,MALE,22,0,0,36,58,219.0
Hunter,2016,MALE,56,136,148,188,528,59.0
Ian,2016,MALE,147,0,330,66,543,58.0
Ibrahim,2016,MALE,111,81,0,57,249,111.0
Ibrahima,2016,MALE,0,13,0,0,13,460.0
Iker,2016,MALE,0,0,38,0,38,260.0
Imran,2016,MALE,0,0,0,12,12,485.0
Isaac,2016,MALE,84,80,456,572,1192,24.0
Isaiah,2016,MALE,0,171,141,33,345,87.0
Isaias,2016,MALE,0,0,14,0,14,434.0
Ismael,2016,MALE,0,0,20,0,20,356.0
Israel,2016,MALE,0,39,48,102,189,123.0
Ivan,2016,MALE,126,0,108,36,270,103.0
Jace,2016,MALE,44,148,188,52,432,70.0
Jack,2016,MALE,54,0,72,534,660,46.0
Jackson,2016,MALE,69,0,84,231,384,78.0
Jacob,2016,MALE,180,228,1404,944,2756,2.0
Jad,2016,MALE,0,0,0,13,13,460.0
Jaden,2016,MALE,81,105,78,0,264,106.0
Jadiel,2016,MALE,0,0,32,0,32,281.0
Jael,2016,MALE,0,0,12,0,12,485.0
Jaiden,2016,MALE,0,36,44,0,80,190.0
Jake,2016,MALE,0,0,76,78,154,138.0
Jamal,2016,MALE,0,10,0,0,10,556.0
Jamari,2016,MALE,0,13,0,0,13,460.0
James,2016,MALE,164,96,332,924,1516,18.0
Jared,2016,MALE,0,0,11,0,11,520.0
Jariel,2016,MALE,0,0,12,0,12,485.0
Jasiah,2016,MALE,0,0,11,0,11,520.0
Jason,2016,MALE,304,132,216,96,748,43.0
Jasper,2016,MALE,70,0,0,38,108,157.0
Javier,2016,MALE,0,0,33,0,33,277.0
Jax,2016,MALE,0,0,11,0,11,520.0
Jaxon,2016,MALE,0,48,78,57,183,126.0
Jaxson,2016,MALE,0,39,57,39,135,145.0
Jay,2016,MALE,0,0,32,24,56,224.0
Jayce,2016,MALE,0,82,88,0,170,128.0
Jayceon,2016,MALE,0,64,20,0,84,184.0
Jaycob,2016,MALE,0,0,16,0,16,403.0
Jayden,2016,MALE,552,300,924,72,1848,13.0
Jaylen,2016,MALE,0,14,0,0,14,434.0
Jayson,2016,MALE,0,0,24,0,24,324.0
Jean,2016,MALE,0,0,14,0,14,434.0
Jefferson,2016,MALE,0,0,19,0,19,369.0
Jeffrey,2016,MALE,30,0,32,0,62,209.0
Jeremiah,2016,MALE,0,202,164,0,366,82.0
Jeremy,2016,MALE,99,0,237,33,369,81.0
Jerry,2016,MALE,18,0,0,0,18,382.0
Jesse,2016,MALE,0,0,0,11,11,520.0
Jesus,2016,MALE,0,0,62,0,62,209.0
Jimmy,2016,MALE,0,0,12,0,12,485.0
Joaquin,2016,MALE,0,0,34,20,54,231.0
Joel,2016,MALE,0,105,165,48,318,91.0
Johan,2016,MALE,0,0,39,0,39,258.0
Johann,2016,MALE,0,0,12,0,12,485.0
John,2016,MALE,68,68,320,584,1040,32.0
Johnny,2016,MALE,26,0,22,0,48,243.0
Jonah,2016,MALE,0,33,81,141,255,110.0
Jonas,2016,MALE,0,26,40,0,66,205.0
Jonathan,2016,MALE,176,140,348,280,944,36.0
Jordan,2016,MALE,72,128,160,100,460,68.0
Jorge,2016,MALE,0,0,25,0,25,319.0
Jose,2016,MALE,0,0,91,0,91,172.0
Josef,2016,MALE,0,0,0,11,11,520.0
Joseph,2016,MALE,116,104,416,1044,1680,15.0
Joshua,2016,MALE,120,376,548,248,1292,20.0
Josiah,2016,MALE,0,182,198,0,380,79.0
Josue,2016,MALE,0,0,32,0,32,281.0
Juan,2016,MALE,0,0,48,0,48,243.0
Judah,2016,MALE,0,26,0,70,96,166.0
Jude,2016,MALE,0,0,0,26,26,313.0
Julian,2016,MALE,112,80,412,340,944,36.0
Julien,2016,MALE,0,0,0,12,12,485.0
Julio,2016,MALE,0,0,22,0,22,337.0
Julius,2016,MALE,0,0,25,0,25,319.0
Justice,2016,MALE,0,16,0,0,16,403.0
Justin,2016,MALE,244,164,376,100,884,38.0
Kabir,2016,MALE,14,0,0,0,14,434.0
Kaden,2016,MALE,0,28,28,0,56,224.0
Kai,2016,MALE,136,112,56,116,420,72.0
Kaiden,2016,MALE,0,94,40,0,134,146.0
Kaleb,2016,MALE,0,44,24,0,68,201.0
Kamari,2016,MALE,0,12,0,0,12,485.0
Kameron,2016,MALE,0,13,0,0,13,460.0
Karter,2016,MALE,0,29,0,0,29,291.0
Kayden,2016,MALE,51,150,171,0,372,80.0
Kelvin,2016,MALE,0,0,11,0,11,520.0
Kendrick,2016,MALE,0,0,10,0,10,556.0
Kenneth,2016,MALE,0,0,24,0,24,324.0
Kenny,2016,MALE,0,0,15,0,15,416.0
Kevin,2016,MALE,256,64,364,68,752,42.0
Khalil,2016,MALE,0,15,0,0,15,416.0
Kian,2016,MALE,13,0,0,0,13,460.0
Kimi,2016,MALE,10,0,0,0,10,556.0
King,2016,MALE,0,128,54,0,182,127.0
Kingsley,2016,MALE,18,0,0,0,18,382.0
Kingston,2016,MALE,0,11,0,0,11,520.0
Krish,2016,MALE,14,0,0,0,14,434.0
Kyle,2016,MALE,176,116,48,68,408,75.0
Kyree,2016,MALE,0,10,0,0,10,556.0
Kyrie,2016,MALE,0,88,28,0,116,153.0
Kyson,2016,MALE,24,0,0,0,24,324.0
Landon,2016,MALE,0,0,26,44,70,199.0
Lawrence,2016,MALE,16,0,0,0,16,403.0
Lazer,2016,MALE,0,0,0,27,27,303.0
Leandro,2016,MALE,0,0,18,0,18,382.0
Legend,2016,MALE,0,17,0,0,17,395.0
Leibish,2016,MALE,0,0,0,10,10,556.0
Lenny,2016,MALE,0,0,11,0,11,520.0
Leo,2016,MALE,153,0,108,363,624,51.0
Leon,2016,MALE,30,0,0,82,112,155.0
Leonard,2016,MALE,0,0,0,14,14,434.0
Leonardo,2016,MALE,0,0,144,82,226,116.0
Leonidas,2016,MALE,0,0,22,20,42,252.0
Lev,2016,MALE,0,0,0,22,22,337.0
Levi,2016,MALE,0,45,54,168,267,104.0
Liam,2016,MALE,304,432,1548,512,2796,1.0
Lincoln,2016,MALE,22,0,0,20,42,252.0
Lionel,2016,MALE,0,0,10,0,10,556.0
Lipa,2016,MALE,0,0,0,29,29,291.0
Logan,2016,MALE,132,260,460,228,1080,30.0
Lorenzo,2016,MALE,0,0,44,46,90,174.0
Louis,2016,MALE,57,0,45,66,168,130.0
Luca,2016,MALE,0,0,32,170,202,121.0
Lucas,2016,MALE,592,112,824,460,1988,8.0
Lucian,2016,MALE,0,0,0,12,12,485.0
Luis,2016,MALE,0,0,88,0,88,176.0
Luka,2016,MALE,0,0,0,27,27,303.0
Lukas,2016,MALE,0,0,30,54,84,184.0
Luke,2016,MALE,69,0,51,291,411,74.0
Maison,2016,MALE,0,46,34,0,80,190.0
Major,2016,MALE,0,20,0,0,20,356.0
Malachi,2016,MALE,0,56,0,0,56,224.0
Malek,2016,MALE,0,0,0,10,10,556.0
Malik,2016,MALE,0,40,0,26,66,205.0
Mamadou,2016,MALE,0,28,0,0,28,297.0
Manuel,2016,MALE,0,0,19,0,19,369.0
Marcel,2016,MALE,0,0,0,11,11,520.0
Marco,2016,MALE,0,0,26,46,72,198.0
Marcos,2016,MALE,0,0,16,0,16,403.0
Marcus,2016,MALE,108,44,60,80,292,96.0
Mario,2016,MALE,0,0,12,0,12,485.0
Mark,2016,MALE,0,0,34,122,156,136.0
Marlon,2016,MALE,0,0,10,0,10,556.0
Martin,2016,MALE,0,0,32,46,78,194.0
Mason,2016,MALE,216,364,672,292,1544,17.0
Mateo,2016,MALE,0,0,276,32,308,94.0
Mathew,2016,MALE,0,0,18,0,18,382.0
Mathias,2016,MALE,0,0,28,0,28,297.0
Matias,2016,MALE,0,0,32,0,32,281.0
Matteo,2016,MALE,0,0,84,56,140,142.0
Matthew,2016,MALE,292,140,1188,508,2128,5.0
Matthias,2016,MALE,0,0,10,0,10,556.0
Max,2016,MALE,105,0,75,297,477,62.0
Maxim,2016,MALE,0,0,0,24,24,324.0
Maximilian,2016,MALE,0,0,20,48,68,201.0
Maximiliano,2016,MALE,0,0,22,0,22,337.0
Maximus,2016,MALE,0,42,51,69,162,133.0
Maxwell,2016,MALE,39,0,42,180,261,108.0
Mayer,2016,MALE,0,0,0,28,28,297.0
Md,2016,MALE,14,0,0,0,14,434.0
Meilech,2016,MALE,0,0,0,10,10,556.0
Meir,2016,MALE,0,0,0,57,57,222.0
Mekhi,2016,MALE,0,15,0,0,15,416.0
Menachem,2016,MALE,0,0,0,87,87,180.0
Mendel,2016,MALE,0,0,0,37,37,265.0
Mendy,2016,MALE,0,0,0,19,19,369.0
Meshilem,2016,MALE,0,0,0,20,20,356.0
Messiah,2016,MALE,0,94,64,0,158,135.0
Meyer,2016,MALE,0,0,0,10,10,556.0
Micah,2016,MALE,0,56,0,26,82,188.0
Michael,2016,MALE,160,284,504,1040,1988,8.0
Miguel,2016,MALE,0,0,39,0,39,258.0
Mikael,2016,MALE,10,0,0,0,10,556.0
Mike,2016,MALE,0,0,10,0,10,556.0
Milan,2016,MALE,0,0,34,22,56,224.0
Miles,2016,MALE,72,40,44,248,404,76.0
Milo,2016,MALE,0,0,0,27,27,303.0
Mohamed,2016,MALE,0,90,0,74,164,132.0
Mohammad,2016,MALE,116,0,0,28,144,141.0
Mohammed,2016,MALE,58,0,0,32,90,174.0
Moises,2016,MALE,0,0,19,0,19,369.0
Moishe,2016,MALE,0,0,0,16,16,403.0
Mordche,2016,MALE,0,0,0,10,10,556.0
Mordechai,2016,MALE,0,0,0,91,91,172.0
Morris,2016,MALE,0,0,0,18,18,382.0
Moses,2016,MALE,0,0,0,37,37,265.0
Moshe,2016,MALE,0,0,0,239,239,112.0
Motty,2016,MALE,0,0,0,11,11,520.0
Mouhamed,2016,MALE,0,14,0,0,14,434.0
Moussa,2016,MALE,0,11,0,0,11,520.0
Muhammad,2016,MALE,471,45,0,51,567,56.0
Musa,2016,MALE,17,0,0,0,17,395.0
Mustafa,2016,MALE,14,0,0,0,14,434.0
Myles,2016,MALE,0,10,0,0,10,556.0
Naftali,2016,MALE,0,0,0,27,27,303.0
Naftuli,2016,MALE,0,0,0,27,27,303.0
Nasir,2016,MALE,0,30,0,0,30,287.0
Nathan,2016,MALE,216,160,332,268,976,34.0
Nathanael,2016,MALE,0,0,11,0,11,520.0
Nathaniel,2016,MALE,88,144,168,232,632,50.0
Nehemiah,2016,MALE,0,11,0,0,11,520.0
Nelson,2016,MALE,20,0,20,0,40,256.0
Nicholas,2016,MALE,108,100,312,544,1064,31.0
Nico,2016,MALE,0,0,0,19,19,369.0
Nicolas,2016,MALE,0,0,104,64,168,130.0
Nikolai,2016,MALE,0,0,0,11,11,520.0
Nikolas,2016,MALE,0,0,0,10,10,556.0
Noach,2016,MALE,0,0,0,10,10,556.0
Noah,2016,MALE,228,592,1076,588,2484,4.0
Noam,2016,MALE,0,0,0,21,21,347.0
Noel,2016,MALE,0,0,22,0,22,337.0
Nolan,2016,MALE,0,51,54,111,216,120.0
Nosson,2016,MALE,0,0,0,10,10,556.0
Oliver,2016,MALE,174,0,183,426,783,41.0
Omar,2016,MALE,0,30,36,192,258,109.0
Omari,2016,MALE,0,28,0,0,28,297.0
Oscar,2016,MALE,72,0,99,144,315,93.0
Otto,2016,MALE,0,0,0,12,12,485.0
Oumar,2016,MALE,0,10,0,0,10,556.0
Ousmane,2016,MALE,0,15,0,0,15,416.0
Owen,2016,MALE,180,0,72,213,465,66.0
Pablo,2016,MALE,0,0,24,0,24,324.0
Parker,2016,MALE,0,0,0,27,27,303.0
Patrick,2016,MALE,0,0,0,36,36,270.0
Paul,2016,MALE,0,0,22,62,84,184.0
Pedro,2016,MALE,0,0,16,0,16,403.0
Peretz,2016,MALE,0,0,0,11,11,520.0
Peter,2016,MALE,0,0,42,82,124,148.0
Peyton,2016,MALE,0,12,0,0,12,485.0
Philip,2016,MALE,0,0,0,27,27,303.0
Pierce,2016,MALE,0,0,0,13,13,460.0
Pinchas,2016,MALE,0,0,0,16,16,403.0
Pinchus,2016,MALE,0,0,0,14,14,434.0
Preston,2016,MALE,30,24,0,0,54,231.0
Prince,2016,MALE,0,70,38,0,108,157.0
Princeton,2016,MALE,0,15,0,0,15,416.0
Quinn,2016,MALE,0,0,0,24,24,324.0
Rafael,2016,MALE,0,0,52,54,106,160.0
Randy,2016,MALE,0,0,13,0,13,460.0
Raphael,2016,MALE,0,0,0,31,31,285.0
Rayan,2016,MALE,54,0,0,54,108,157.0
Raymond,2016,MALE,75,0,42,45,162,133.0
Rayyan,2016,MALE,19,0,0,0,19,369.0
Rehan,2016,MALE,13,0,0,0,13,460.0
Reid,2016,MALE,0,0,0,21,21,347.0
Reuven,2016,MALE,0,0,0,14,14,434.0
Ricardo,2016,MALE,0,0,18,0,18,382.0
Richard,2016,MALE,56,72,80,108,316,92.0
River,2016,MALE,0,0,0,13,13,460.0
Robert,2016,MALE,40,72,92,272,476,63.0
Roberto,2016,MALE,0,0,14,0,14,434.0
Rocco,2016,MALE,0,0,0,30,30,287.0
Rodrigo,2016,MALE,0,0,12,0,12,485.0
Rohan,2016,MALE,24,0,0,0,24,324.0
Roman,2016,MALE,0,0,30,56,86,181.0
Ronan,2016,MALE,0,0,0,15,15,416.0
Rowan,2016,MALE,0,0,0,22,22,337.0
Roy,2016,MALE,16,0,0,0,16,403.0
Royal,2016,MALE,0,17,0,0,17,395.0
Russell,2016,MALE,0,0,0,11,11,520.0
Ryan,2016,MALE,640,168,412,516,1736,14.0
Ryder,2016,MALE,20,0,0,30,50,239.0
Salvatore,2016,MALE,0,0,0,19,19,369.0
Sam,2016,MALE,0,0,0,37,37,265.0
Sami,2016,MALE,0,0,0,12,12,485.0
Samir,2016,MALE,0,0,0,17,17,395.0
Samuel,2016,MALE,156,180,332,624,1292,20.0
Santiago,2016,MALE,0,0,54,0,54,231.0
Santino,2016,MALE,0,0,0,11,11,520.0
Sean,2016,MALE,100,60,40,88,288,98.0
Sebastian,2016,MALE,80,108,1024,336,1548,16.0
Selim,2016,MALE,0,0,0,12,12,485.0
Sergio,2016,MALE,0,0,13,0,13,460.0
Shalom,2016,MALE,0,0,0,11,11,520.0
Shane,2016,MALE,0,28,0,34,62,209.0
Shawn,2016,MALE,12,0,0,0,12,485.0
Shaya,2016,MALE,0,0,0,53,53,236.0
Shia,2016,MALE,0,0,0,24,24,324.0
Shimon,2016,MALE,0,0,0,100,100,161.0
Shloime,2016,MALE,0,0,0,19,19,369.0
Shloimy,2016,MALE,0,0,0,19,19,369.0
Shlome,2016,MALE,0,0,0,20,20,356.0
Shlomo,2016,MALE,0,0,0,67,67,203.0
Shmiel,2016,MALE,0,0,0,31,31,285.0
Shmuel,2016,MALE,0,0,0,60,60,216.0
Sholom,2016,MALE,0,0,0,12,12,485.0
Shraga,2016,MALE,0,0,0,11,11,520.0
Shulem,2016,MALE,0,0,0,33,33,277.0
Silas,2016,MALE,0,0,0,14,14,434.0
Simcha,2016,MALE,0,0,0,29,29,291.0
Simon,2016,MALE,22,0,0,102,124,148.0
Sincere,2016,MALE,0,13,0,0,13,460.0
Solomon,2016,MALE,0,0,0,43,43,250.0
Spencer,2016,MALE,0,0,0,22,22,337.0
Stanley,2016,MALE,12,0,0,0,12,485.0
Stephen,2016,MALE,0,0,0,13,13,460.0
Steven,2016,MALE,63,0,165,39,267,104.0
Sulaiman,2016,MALE,10,0,0,0,10,556.0
Syed,2016,MALE,38,0,0,0,38,260.0
Tenzin,2016,MALE,34,0,0,0,34,273.0
Terry,2016,MALE,10,0,0,0,10,556.0
Theo,2016,MALE,0,0,0,25,25,319.0
Theodore,2016,MALE,56,0,0,234,290,97.0
Thiago,2016,MALE,0,0,55,0,55,229.0
Thomas,2016,MALE,51,0,72,336,459,69.0
Timothy,2016,MALE,40,52,44,88,224,118.0
Timur,2016,MALE,0,0,0,14,14,434.0
Tristan,2016,MALE,84,152,72,52,360,84.0
Tyler,2016,MALE,92,232,128,116,568,55.0
Tzvi,2016,MALE,0,0,0,49,49,241.0
Umar,2016,MALE,0,0,0,10,10,556.0
Uriel,2016,MALE,0,0,18,0,18,382.0
Usher,2016,MALE,0,0,0,21,21,347.0
Valentino,2016,MALE,0,0,14,0,14,434.0
Victor,2016,MALE,40,48,116,96,300,95.0
Vincent,2016,MALE,153,0,63,141,357,85.0
Vincenzo,2016,MALE,0,0,0,15,15,416.0
Walker,2016,MALE,0,0,0,10,10,556.0
Walter,2016,MALE,0,0,0,11,11,520.0
Wesley,2016,MALE,40,0,0,58,98,162.0
William,2016,MALE,248,72,204,676,1200,22.0
Wilson,2016,MALE,10,0,0,0,10,556.0
Winston,2016,MALE,42,0,0,20,62,209.0
Wolf,2016,MALE,0,0,0,11,11,520.0
Wyatt,2016,MALE,0,20,0,78,98,162.0
Xavier,2016,MALE,76,156,292,52,576,54.0
Yaakov,2016,MALE,0,0,0,43,43,250.0
Yadiel,2016,MALE,0,0,14,0,14,434.0
Yakov,2016,MALE,0,0,0,57,57,222.0
Yassin,2016,MALE,0,0,0,11,11,520.0
Yechiel,2016,MALE,0,0,0,28,28,297.0
Yehoshua,2016,MALE,0,0,0,21,21,347.0
Yehuda,2016,MALE,0,0,0,88,88,176.0
Yisrael,2016,MALE,0,0,0,14,14,434.0
Yisroel,2016,MALE,0,0,0,98,98,162.0
Yitzchak,2016,MALE,0,0,0,13,13,460.0
Yitzchok,2016,MALE,0,0,0,67,67,203.0
Yoel,2016,MALE,0,0,0,14,14,434.0
Yonatan,2016,MALE,0,0,0,12,12,485.0
Yosef,2016,MALE,0,0,0,114,114,154.0
Yossi,2016,MALE,0,0,0,17,17,395.0
Yousef,2016,MALE,0,0,0,26,26,313.0
Youssef,2016,MALE,0,0,0,21,21,347.0
Yusuf,2016,MALE,38,0,0,50,88,176.0
Zabdiel,2016,MALE,0,0,11,0,11,520.0
Zachary,2016,MALE,100,116,108,320,644,49.0
Zain,2016,MALE,0,0,0,11,11,520.0
Zaire,2016,MALE,0,16,0,0,16,403.0
Zalmen,2016,MALE,0,0,0,15,15,416.0
Zayan,2016,MALE,14,0,0,0,14,434.0
Zayden,2016,MALE,0,20,38,0,58,219.0
Zayn,2016,MALE,42,0,0,24,66,205.0
Zev,2016,MALE,0,0,0,45,45,248.0
Zion,2016,MALE,0,108,38,0,146,140.0
Aaliyah,2017,FEMALE,30,144,135,0,309,60.0
Abby,2017,FEMALE,28,0,20,0,48,226.0
Abigail,2017,FEMALE,120,156,496,448,1220,10.0
Ada,2017,FEMALE,22,0,0,28,50,220.0
Adalynn,2017,FEMALE,0,0,10,0,10,593.0
Addison,2017,FEMALE,0,0,26,44,70,178.0
Adelaide,2017,FEMALE,0,0,0,13,13,463.0
Adele,2017,FEMALE,0,0,22,62,84,157.0
Adeline,2017,FEMALE,0,0,32,46,78,169.0
Adelyn,2017,FEMALE,0,0,12,0,12,499.0
Adina,2017,FEMALE,0,0,0,21,21,334.0
Adriana,2017,FEMALE,0,0,56,52,108,127.0
Ahuva,2017,FEMALE,0,0,0,20,20,344.0
Aicha,2017,FEMALE,0,15,0,0,15,414.0
Aileen,2017,FEMALE,0,0,15,0,15,414.0
Aimee,2017,FEMALE,0,0,10,0,10,593.0
Aisha,2017,FEMALE,51,66,0,33,150,104.0
Aissatou,2017,FEMALE,0,16,0,0,16,391.0
Aitana,2017,FEMALE,0,0,11,0,11,543.0
Aiza,2017,FEMALE,14,0,0,0,14,434.0
Aizah,2017,FEMALE,11,0,0,0,11,543.0
Alaia,2017,FEMALE,0,0,47,0,47,233.0
Alaina,2017,FEMALE,0,0,10,0,10,593.0
Alana,2017,FEMALE,0,26,34,0,60,200.0
Alani,2017,FEMALE,0,20,44,0,64,194.0
Alanna,2017,FEMALE,0,0,15,0,15,414.0
Alba,2017,FEMALE,0,0,10,0,10,593.0
Aleah,2017,FEMALE,0,0,11,0,11,543.0
Aleena,2017,FEMALE,13,0,0,0,13,463.0
Alejandra,2017,FEMALE,0,0,10,0,10,593.0
Alessandra,2017,FEMALE,0,0,30,46,76,172.0
Alessia,2017,FEMALE,0,0,0,22,22,322.0
Alexa,2017,FEMALE,0,0,134,58,192,86.0
Alexandra,2017,FEMALE,39,0,72,240,351,55.0
Alexis,2017,FEMALE,0,32,0,24,56,207.0
Alia,2017,FEMALE,0,0,11,0,11,543.0
Aliah,2017,FEMALE,0,0,13,0,13,463.0
Alice,2017,FEMALE,105,0,84,168,357,53.0
Alicia,2017,FEMALE,0,0,11,0,11,543.0
Alina,2017,FEMALE,111,0,45,60,216,78.0
Alisa,2017,FEMALE,0,0,0,10,10,593.0
Alisha,2017,FEMALE,22,0,0,0,22,322.0
Alison,2017,FEMALE,0,0,20,0,20,344.0
Aliyah,2017,FEMALE,0,38,46,0,84,157.0
Aliza,2017,FEMALE,34,0,0,32,66,187.0
Allison,2017,FEMALE,0,0,108,22,130,115.0
Alma,2017,FEMALE,0,0,26,54,80,165.0
Alondra,2017,FEMALE,0,0,11,0,11,543.0
Alyssa,2017,FEMALE,52,72,128,72,324,58.0
Amaia,2017,FEMALE,0,0,26,0,26,284.0
Amalia,2017,FEMALE,0,0,66,30,96,142.0
Amanda,2017,FEMALE,34,0,58,0,92,144.0
Amara,2017,FEMALE,22,30,0,0,52,212.0
Amaya,2017,FEMALE,0,50,90,0,140,110.0
Amber,2017,FEMALE,28,0,32,0,60,200.0
Amelia,2017,FEMALE,176,188,328,472,1164,11.0
Amelie,2017,FEMALE,0,0,20,24,44,239.0
Amina,2017,FEMALE,30,72,0,84,186,89.0
Aminata,2017,FEMALE,0,25,0,0,25,287.0
Amira,2017,FEMALE,44,100,44,44,232,76.0
Amirah,2017,FEMALE,0,21,0,0,21,334.0
Amiyah,2017,FEMALE,0,21,0,0,21,334.0
Amy,2017,FEMALE,46,0,132,0,178,93.0
Ana,2017,FEMALE,0,0,66,22,88,151.0
Anabella,2017,FEMALE,0,0,10,0,10,593.0
Anabia,2017,FEMALE,14,0,0,0,14,434.0
Analia,2017,FEMALE,0,0,10,0,10,593.0
Anastasia,2017,FEMALE,0,0,24,58,82,161.0
Anaya,2017,FEMALE,52,22,0,0,74,174.0
Andrea,2017,FEMALE,0,0,28,0,28,272.0
Angel,2017,FEMALE,20,32,0,0,52,212.0
Angela,2017,FEMALE,62,0,36,0,98,141.0
Angelica,2017,FEMALE,0,0,15,0,15,414.0
Angelina,2017,FEMALE,72,0,90,90,252,72.0
Angie,2017,FEMALE,0,0,15,0,15,414.0
Anisa,2017,FEMALE,0,0,0,12,12,499.0
Aniyah,2017,FEMALE,0,16,0,0,16,391.0
Anna,2017,FEMALE,81,0,39,201,321,59.0
Annabelle,2017,FEMALE,0,0,20,50,70,178.0
Annie,2017,FEMALE,26,0,0,0,26,284.0
Antonella,2017,FEMALE,0,0,20,0,20,344.0
Antonia,2017,FEMALE,0,0,0,11,11,543.0
April,2017,FEMALE,0,0,11,0,11,543.0
Arabella,2017,FEMALE,0,0,0,12,12,499.0
Aria,2017,FEMALE,160,124,156,208,648,26.0
Ariadna,2017,FEMALE,0,0,10,0,10,593.0
Ariadne,2017,FEMALE,0,0,12,0,12,499.0
Ariah,2017,FEMALE,0,27,0,0,27,278.0
Ariana,2017,FEMALE,132,44,272,148,596,29.0
Arianna,2017,FEMALE,44,76,212,64,396,44.0
Arianny,2017,FEMALE,0,0,10,0,10,593.0
Ariel,2017,FEMALE,42,84,48,0,174,95.0
Ariella,2017,FEMALE,0,0,40,68,108,127.0
Arielle,2017,FEMALE,0,18,0,0,18,366.0
Arisha,2017,FEMALE,14,0,0,0,14,434.0
Ariyah,2017,FEMALE,0,14,0,0,14,434.0
Arlette,2017,FEMALE,0,0,11,0,11,543.0
Arya,2017,FEMALE,102,48,48,0,198,84.0
Ashley,2017,FEMALE,93,36,318,0,447,41.0
Athena,2017,FEMALE,36,0,39,30,105,134.0
Aubree,2017,FEMALE,0,16,0,0,16,391.0
Aubrey,2017,FEMALE,0,45,102,42,189,88.0
Audrey,2017,FEMALE,66,0,36,132,234,74.0
Aurora,2017,FEMALE,42,0,72,69,183,91.0
Autumn,2017,FEMALE,0,52,28,0,80,165.0
Ava,2017,FEMALE,184,452,468,628,1732,6.0
Avery,2017,FEMALE,80,108,128,208,524,34.0
Avigail,2017,FEMALE,0,0,0,16,16,391.0
Aviva,2017,FEMALE,0,0,0,11,11,543.0
Aya,2017,FEMALE,0,0,0,18,18,366.0
Ayala,2017,FEMALE,0,0,0,11,11,543.0
Ayat,2017,FEMALE,10,0,0,0,10,593.0
Ayesha,2017,FEMALE,24,0,0,0,24,300.0
Ayla,2017,FEMALE,0,0,22,42,64,194.0
Ayleen,2017,FEMALE,0,0,10,0,10,593.0
Aylin,2017,FEMALE,0,0,25,0,25,287.0
Azariah,2017,FEMALE,0,10,0,0,10,593.0
Baila,2017,FEMALE,0,0,0,42,42,245.0
Batsheva,2017,FEMALE,0,0,0,14,14,434.0
Beatrice,2017,FEMALE,0,0,0,25,25,287.0
Bella,2017,FEMALE,152,116,212,172,652,25.0
Bianca,2017,FEMALE,0,0,26,26,52,212.0
Blake,2017,FEMALE,0,0,0,12,12,499.0
Blessing,2017,FEMALE,0,15,0,0,15,414.0
Blima,2017,FEMALE,0,0,0,16,16,391.0
Blimy,2017,FEMALE,0,0,0,24,24,300.0
Bracha,2017,FEMALE,0,0,0,23,23,310.0
Breindy,2017,FEMALE,0,0,0,16,16,391.0
Briana,2017,FEMALE,0,0,15,0,15,414.0
Brianna,2017,FEMALE,0,42,204,42,288,66.0
Brianny,2017,FEMALE,0,0,10,0,10,593.0
Bridget,2017,FEMALE,0,0,0,17,17,378.0
Brielle,2017,FEMALE,0,126,42,42,210,81.0
Brittany,2017,FEMALE,0,0,13,0,13,463.0
Brooke,2017,FEMALE,0,28,0,42,70,178.0
Bruchy,2017,FEMALE,0,0,0,25,25,287.0
Cali,2017,FEMALE,0,10,0,0,10,593.0
Cameron,2017,FEMALE,0,0,0,13,13,463.0
Camila,2017,FEMALE,0,0,356,20,376,47.0
Camilla,2017,FEMALE,0,0,34,24,58,206.0
Camille,2017,FEMALE,0,0,0,11,11,543.0
Carina,2017,FEMALE,13,0,0,0,13,463.0
Caroline,2017,FEMALE,0,0,22,82,104,135.0
Catalina,2017,FEMALE,0,0,22,0,22,322.0
Catherine,2017,FEMALE,36,0,0,52,88,151.0
Cecilia,2017,FEMALE,0,0,20,54,74,174.0
Celeste,2017,FEMALE,0,0,20,20,40,248.0
Celia,2017,FEMALE,0,0,0,13,13,463.0
Celine,2017,FEMALE,112,48,56,56,272,69.0
Chana,2017,FEMALE,0,0,0,132,132,114.0
Chanel,2017,FEMALE,0,10,0,0,10,593.0
Chany,2017,FEMALE,0,0,0,37,37,253.0
Charlie,2017,FEMALE,0,0,0,16,16,391.0
Charlotte,2017,FEMALE,228,88,216,628,1160,12.0
Chava,2017,FEMALE,0,0,0,29,29,266.0
Chavy,2017,FEMALE,0,0,0,23,23,310.0
Chaya,2017,FEMALE,0,0,0,196,196,85.0
Chelsea,2017,FEMALE,36,72,78,0,186,89.0
Chiara,2017,FEMALE,0,0,0,12,12,499.0
Chloe,2017,FEMALE,412,144,244,292,1092,13.0
Christina,2017,FEMALE,18,0,0,0,18,366.0
Cindy,2017,FEMALE,11,0,0,0,11,543.0
Claire,2017,FEMALE,120,0,33,156,309,60.0
Clara,2017,FEMALE,0,0,0,23,23,310.0
Colette,2017,FEMALE,0,0,0,17,17,378.0
Cora,2017,FEMALE,0,0,0,22,22,322.0
Crystal,2017,FEMALE,26,0,26,0,52,212.0
Cynthia,2017,FEMALE,17,0,0,0,17,378.0
Daisy,2017,FEMALE,0,0,44,24,68,182.0
Dakota,2017,FEMALE,0,25,0,0,25,287.0
Daleyza,2017,FEMALE,0,0,13,0,13,463.0
Daniela,2017,FEMALE,0,0,41,0,41,246.0
Daniella,2017,FEMALE,0,0,38,34,72,176.0
Danielle,2017,FEMALE,0,0,0,12,12,499.0
Danna,2017,FEMALE,0,0,23,0,23,310.0
Daphne,2017,FEMALE,30,0,36,33,99,140.0
Dayana,2017,FEMALE,0,0,14,0,14,434.0
Deborah,2017,FEMALE,0,0,10,0,10,593.0
Delilah,2017,FEMALE,0,0,29,0,29,266.0
Destiny,2017,FEMALE,0,38,28,0,66,187.0
Devora,2017,FEMALE,0,0,0,25,25,287.0
Devorah,2017,FEMALE,0,0,0,28,28,272.0
Diana,2017,FEMALE,0,0,52,52,104,135.0
Dina,2017,FEMALE,0,0,0,47,47,233.0
Dylan,2017,FEMALE,0,0,0,23,23,310.0
Eden,2017,FEMALE,0,0,0,20,20,344.0
Edith,2017,FEMALE,0,0,0,14,14,434.0
Egypt,2017,FEMALE,0,21,0,0,21,334.0
Elaine,2017,FEMALE,13,0,0,0,13,463.0
Eleanor,2017,FEMALE,44,0,0,164,208,83.0
Elena,2017,FEMALE,57,0,117,42,216,78.0
Eliana,2017,FEMALE,42,0,105,162,309,60.0
Elise,2017,FEMALE,20,0,0,28,48,226.0
Eliza,2017,FEMALE,0,0,20,48,68,182.0
Elizabeth,2017,FEMALE,144,60,324,424,952,15.0
Ella,2017,FEMALE,196,92,112,488,888,18.0
Elle,2017,FEMALE,0,0,0,31,31,262.0
Ellie,2017,FEMALE,54,0,0,52,106,130.0
Eloise,2017,FEMALE,0,0,0,27,27,278.0
Emely,2017,FEMALE,0,0,50,0,50,220.0
Emerson,2017,FEMALE,0,0,0,18,18,366.0
Emery,2017,FEMALE,0,0,0,12,12,499.0
Emilia,2017,FEMALE,36,0,111,213,360,52.0
Emily,2017,FEMALE,312,120,480,404,1316,8.0
Emma,2017,FEMALE,436,124,888,796,2244,1.0
Empress,2017,FEMALE,0,12,0,0,12,499.0
Erin,2017,FEMALE,10,0,0,0,10,593.0
Eshaal,2017,FEMALE,16,0,0,0,16,391.0
Esmeralda,2017,FEMALE,0,0,12,0,12,499.0
Estelle,2017,FEMALE,0,0,0,11,11,543.0
Esther,2017,FEMALE,0,0,22,520,542,30.0
Esty,2017,FEMALE,0,0,0,31,31,262.0
Etty,2017,FEMALE,0,0,0,12,12,499.0
Eva,2017,FEMALE,104,44,116,232,496,35.0
Evangeline,2017,FEMALE,0,0,10,0,10,593.0
Eve,2017,FEMALE,0,0,0,21,21,334.0
Evelyn,2017,FEMALE,129,0,132,276,537,32.0
Everly,2017,FEMALE,0,0,24,36,60,200.0
Evie,2017,FEMALE,0,0,0,10,10,593.0
Faiga,2017,FEMALE,0,0,0,23,23,310.0
Faigy,2017,FEMALE,0,0,0,67,67,186.0
Faith,2017,FEMALE,0,70,20,0,90,148.0
Farida,2017,FEMALE,0,0,0,12,12,499.0
Fatima,2017,FEMALE,156,128,48,52,384,46.0
Fatou,2017,FEMALE,0,11,0,0,11,543.0
Fatoumata,2017,FEMALE,0,38,0,0,38,252.0
Fernanda,2017,FEMALE,0,0,16,0,16,391.0
Finley,2017,FEMALE,0,0,0,12,12,499.0
Fiona,2017,FEMALE,42,0,0,80,122,119.0
Fradel,2017,FEMALE,0,0,0,16,16,391.0
Frady,2017,FEMALE,0,0,0,16,16,391.0
Fraidy,2017,FEMALE,0,0,0,24,24,300.0
Frances,2017,FEMALE,0,0,0,27,27,278.0
Francesca,2017,FEMALE,0,0,0,26,26,284.0
Freida,2017,FEMALE,0,0,0,12,12,499.0
Frieda,2017,FEMALE,0,0,0,12,12,499.0
Gabriela,2017,FEMALE,0,0,68,20,88,151.0
Gabriella,2017,FEMALE,0,63,162,147,372,48.0
Gabrielle,2017,FEMALE,0,28,0,32,60,200.0
Gaia,2017,FEMALE,0,0,0,11,11,543.0
Galilea,2017,FEMALE,0,0,14,0,14,434.0
Gemma,2017,FEMALE,0,0,0,18,18,366.0
Genesis,2017,FEMALE,0,36,178,0,214,80.0
Genevieve,2017,FEMALE,0,0,0,18,18,366.0
Georgia,2017,FEMALE,0,0,0,17,17,378.0
Gia,2017,FEMALE,0,0,26,20,46,235.0
Gianna,2017,FEMALE,0,51,153,105,309,60.0
Giselle,2017,FEMALE,0,0,17,0,17,378.0
Gittel,2017,FEMALE,0,0,0,23,23,310.0
Gitty,2017,FEMALE,0,0,0,89,89,150.0
Giuliana,2017,FEMALE,0,0,0,20,20,344.0
Golda,2017,FEMALE,0,0,0,17,17,378.0
Goldy,2017,FEMALE,0,0,0,32,32,259.0
Grace,2017,FEMALE,176,92,184,316,768,22.0
Guadalupe,2017,FEMALE,0,0,10,0,10,593.0
Gwendolyn,2017,FEMALE,0,0,0,12,12,499.0
Hadassah,2017,FEMALE,0,0,0,19,19,360.0
Hafsa,2017,FEMALE,12,0,0,0,12,499.0
Hailey,2017,FEMALE,68,84,260,116,528,33.0
Hana,2017,FEMALE,34,0,0,44,78,169.0
Hanna,2017,FEMALE,0,0,0,20,20,344.0
Hannah,2017,FEMALE,292,72,144,320,828,21.0
Harley,2017,FEMALE,0,0,28,22,50,220.0
Harlow,2017,FEMALE,0,0,0,10,10,593.0
Harmony,2017,FEMALE,0,25,0,0,25,287.0
Harper,2017,FEMALE,46,0,0,80,126,116.0
Hawa,2017,FEMALE,0,24,0,0,24,300.0
Haylee,2017,FEMALE,0,0,14,0,14,434.0
Hazel,2017,FEMALE,36,0,54,102,192,86.0
Heaven,2017,FEMALE,0,20,0,0,20,344.0
Helen,2017,FEMALE,20,0,30,0,50,220.0
Helena,2017,FEMALE,0,0,0,11,11,543.0
Henny,2017,FEMALE,0,0,0,25,25,287.0
Hinda,2017,FEMALE,0,0,0,14,14,434.0
Hindy,2017,FEMALE,0,0,0,48,48,226.0
Hope,2017,FEMALE,0,0,0,10,10,593.0
Idy,2017,FEMALE,0,0,0,14,14,434.0
Imani,2017,FEMALE,0,23,0,0,23,310.0
Imogen,2017,FEMALE,0,0,0,11,11,543.0
Inaaya,2017,FEMALE,28,0,0,0,28,272.0
Irene,2017,FEMALE,14,0,0,0,14,434.0
Iris,2017,FEMALE,52,0,0,38,90,148.0
Isabel,2017,FEMALE,54,0,87,84,225,77.0
Isabella,2017,FEMALE,184,184,980,520,1868,5.0
Isabelle,2017,FEMALE,72,72,76,132,352,54.0
Isla,2017,FEMALE,0,0,0,34,34,256.0
Itzel,2017,FEMALE,0,0,15,0,15,414.0
Ivy,2017,FEMALE,28,0,0,22,50,220.0
Izabella,2017,FEMALE,0,0,15,0,15,414.0
Jacqueline,2017,FEMALE,0,0,0,15,15,414.0
Jada,2017,FEMALE,0,13,0,0,13,463.0
Jade,2017,FEMALE,0,50,88,0,138,113.0
Jaliyah,2017,FEMALE,0,10,0,0,10,593.0
Jana,2017,FEMALE,0,0,0,15,15,414.0
Jane,2017,FEMALE,0,0,0,25,25,287.0
Janice,2017,FEMALE,13,0,0,0,13,463.0
Janiyah,2017,FEMALE,0,10,0,0,10,593.0
Jannat,2017,FEMALE,12,0,0,0,12,499.0
Jaslene,2017,FEMALE,0,0,11,0,11,543.0
Jasmine,2017,FEMALE,69,42,54,0,165,96.0
Jayla,2017,FEMALE,0,56,50,0,106,130.0
Jaylah,2017,FEMALE,0,0,10,0,10,593.0
Jayleen,2017,FEMALE,0,0,27,0,27,278.0
Jaylene,2017,FEMALE,0,0,10,0,10,593.0
Jaylin,2017,FEMALE,0,0,15,0,15,414.0
Jazlyn,2017,FEMALE,0,0,32,0,32,259.0
Jazmin,2017,FEMALE,0,0,22,0,22,322.0
Jazmine,2017,FEMALE,0,0,10,0,10,593.0
Jenna,2017,FEMALE,0,0,0,14,14,434.0
Jennifer,2017,FEMALE,0,0,23,0,23,310.0
Jenny,2017,FEMALE,15,0,0,0,15,414.0
Jessica,2017,FEMALE,42,0,24,0,66,187.0
Jessie,2017,FEMALE,11,0,0,0,11,543.0
Joanna,2017,FEMALE,18,0,0,0,18,366.0
Jocelyn,2017,FEMALE,30,0,26,0,56,207.0
Jordan,2017,FEMALE,0,26,0,20,46,235.0
Jordyn,2017,FEMALE,0,10,0,0,10,593.0
Joselyn,2017,FEMALE,0,0,13,0,13,463.0
Josephine,2017,FEMALE,0,0,0,44,44,239.0
Josie,2017,FEMALE,0,0,0,10,10,593.0
Journee,2017,FEMALE,0,16,0,0,16,391.0
Journey,2017,FEMALE,0,17,0,0,17,378.0
Joy,2017,FEMALE,32,24,0,0,56,207.0
Joyce,2017,FEMALE,11,0,0,0,11,543.0
Julia,2017,FEMALE,36,0,84,213,333,57.0
Juliana,2017,FEMALE,0,0,40,62,102,137.0
Julianna,2017,FEMALE,0,0,24,56,80,165.0
Julie,2017,FEMALE,0,0,0,16,16,391.0
Juliet,2017,FEMALE,0,0,58,44,102,137.0
Juliette,2017,FEMALE,0,0,78,70,148,105.0
June,2017,FEMALE,0,0,0,15,15,414.0
Juniper,2017,FEMALE,0,0,0,14,14,434.0
Kadiatou,2017,FEMALE,0,13,0,0,13,463.0
Kaia,2017,FEMALE,0,0,0,15,15,414.0
Kailey,2017,FEMALE,0,0,10,0,10,593.0
Kaitlyn,2017,FEMALE,22,0,22,0,44,239.0
Kali,2017,FEMALE,0,20,0,0,20,344.0
Kaliyah,2017,FEMALE,0,10,0,0,10,593.0
Kamila,2017,FEMALE,0,0,28,0,28,272.0
Karen,2017,FEMALE,22,0,26,0,48,226.0
Karina,2017,FEMALE,22,0,0,0,22,322.0
Karla,2017,FEMALE,0,0,17,0,17,378.0
Kate,2017,FEMALE,0,0,0,13,13,463.0
Katerina,2017,FEMALE,0,0,0,11,11,543.0
Katherine,2017,FEMALE,78,0,105,99,282,67.0
Kayla,2017,FEMALE,116,96,132,112,456,39.0
Kaylani,2017,FEMALE,0,0,17,0,17,378.0
Kaylee,2017,FEMALE,45,90,168,0,303,64.0
Kehlani,2017,FEMALE,0,11,0,0,11,543.0
Keily,2017,FEMALE,0,0,18,0,18,366.0
Keira,2017,FEMALE,0,0,0,13,13,463.0
Kelly,2017,FEMALE,13,0,0,0,13,463.0
Kelsey,2017,FEMALE,0,14,0,0,14,434.0
Kennedi,2017,FEMALE,0,10,0,0,10,593.0
Kennedy,2017,FEMALE,0,40,0,30,70,178.0
Keyla,2017,FEMALE,0,0,20,0,20,344.0
Khadija,2017,FEMALE,20,26,0,0,46,235.0
Khaleesi,2017,FEMALE,0,0,10,0,10,593.0
Khloe,2017,FEMALE,0,26,54,0,80,165.0
Kiara,2017,FEMALE,0,20,42,0,62,198.0
Kimberly,2017,FEMALE,0,0,44,0,44,239.0
Kimora,2017,FEMALE,0,12,0,0,12,499.0
Kira,2017,FEMALE,22,0,0,26,48,226.0
Kori,2017,FEMALE,0,10,0,0,10,593.0
Kyla,2017,FEMALE,0,11,0,0,11,543.0
Kylie,2017,FEMALE,0,42,122,0,164,97.0
Laila,2017,FEMALE,0,81,48,48,177,94.0
Lana,2017,FEMALE,0,0,0,13,13,463.0
Lara,2017,FEMALE,0,0,0,22,22,322.0
Laura,2017,FEMALE,0,0,0,14,14,434.0
Lauren,2017,FEMALE,0,42,33,36,111,124.0
Layan,2017,FEMALE,0,0,0,11,11,543.0
Layla,2017,FEMALE,60,104,180,196,540,31.0
Lea,2017,FEMALE,0,0,0,11,11,543.0
Leah,2017,FEMALE,68,116,472,924,1580,7.0
Leia,2017,FEMALE,0,0,17,0,17,378.0
Leila,2017,FEMALE,0,36,54,57,147,107.0
Leilani,2017,FEMALE,0,50,60,0,110,125.0
Lena,2017,FEMALE,0,0,0,19,19,360.0
Leora,2017,FEMALE,0,0,0,12,12,499.0
Leslie,2017,FEMALE,0,0,33,0,33,258.0
Lesly,2017,FEMALE,0,0,10,0,10,593.0
Leyla,2017,FEMALE,0,0,12,0,12,499.0
Lia,2017,FEMALE,0,0,50,58,108,127.0
Liana,2017,FEMALE,30,0,36,60,126,116.0
Liba,2017,FEMALE,0,0,0,17,17,378.0
Libby,2017,FEMALE,0,0,0,29,29,266.0
Lielle,2017,FEMALE,0,0,0,10,10,593.0
Lila,2017,FEMALE,0,0,0,25,25,287.0
Liliana,2017,FEMALE,0,0,52,54,106,130.0
Lillian,2017,FEMALE,30,0,0,82,112,122.0
Lilly,2017,FEMALE,0,0,0,10,10,593.0
Lily,2017,FEMALE,51,0,51,312,414,42.0
Lina,2017,FEMALE,0,0,0,21,21,334.0
Liv,2017,FEMALE,0,0,0,17,17,378.0
Livia,2017,FEMALE,22,0,0,30,52,212.0
Lizbeth,2017,FEMALE,0,0,13,0,13,463.0
Lola,2017,FEMALE,0,0,0,24,24,300.0
London,2017,FEMALE,0,44,40,0,84,157.0
Londyn,2017,FEMALE,0,16,0,0,16,391.0
Louisa,2017,FEMALE,0,0,0,15,15,414.0
Louise,2017,FEMALE,0,0,0,13,13,463.0
Lucia,2017,FEMALE,0,0,56,50,106,130.0
Luciana,2017,FEMALE,0,0,12,0,12,499.0
Lucy,2017,FEMALE,0,0,0,66,66,187.0
Luna,2017,FEMALE,57,0,324,102,483,37.0
Lydia,2017,FEMALE,24,0,0,24,48,226.0
Lyla,2017,FEMALE,0,0,0,23,23,310.0
Lyric,2017,FEMALE,0,12,0,0,12,499.0
Mabel,2017,FEMALE,0,0,0,11,11,543.0
Mackenzie,2017,FEMALE,0,0,28,64,92,144.0
Madeleine,2017,FEMALE,0,0,0,22,22,322.0
Madeline,2017,FEMALE,42,0,33,135,210,81.0
Madelyn,2017,FEMALE,0,0,28,56,84,157.0
Madina,2017,FEMALE,0,0,0,11,11,543.0
Madison,2017,FEMALE,92,288,328,232,940,16.0
Maeve,2017,FEMALE,0,0,0,27,27,278.0
Mahnoor,2017,FEMALE,13,0,0,0,13,463.0
Maia,2017,FEMALE,0,0,25,0,25,287.0
Maimouna,2017,FEMALE,0,10,0,0,10,593.0
Maisie,2017,FEMALE,0,0,0,11,11,543.0
Makayla,2017,FEMALE,0,19,0,0,19,360.0
Malak,2017,FEMALE,0,0,0,13,13,463.0
Malia,2017,FEMALE,0,76,24,0,100,139.0
Maliyah,2017,FEMALE,0,11,0,0,11,543.0
Malka,2017,FEMALE,0,0,0,86,86,155.0
Malky,2017,FEMALE,0,0,0,72,72,176.0
Manha,2017,FEMALE,22,0,0,0,22,322.0
Margaret,2017,FEMALE,0,0,0,21,21,334.0
Margot,2017,FEMALE,0,0,0,32,32,259.0
Maria,2017,FEMALE,0,0,74,86,160,99.0
Mariah,2017,FEMALE,0,16,0,0,16,391.0
Mariam,2017,FEMALE,0,56,0,54,110,125.0
Mariama,2017,FEMALE,0,15,0,0,15,414.0
Mariana,2017,FEMALE,0,0,17,0,17,378.0
Marie,2017,FEMALE,0,0,0,10,10,593.0
Marilyn,2017,FEMALE,0,0,11,0,11,543.0
Mary,2017,FEMALE,0,0,0,14,14,434.0
Maryam,2017,FEMALE,66,30,0,87,183,91.0
Matilda,2017,FEMALE,0,0,0,16,16,391.0
Maya,2017,FEMALE,136,112,208,424,880,19.0
McKenzie,2017,FEMALE,0,12,0,0,12,499.0
Melania,2017,FEMALE,0,0,0,11,11,543.0
Melanie,2017,FEMALE,0,28,120,0,148,105.0
Melany,2017,FEMALE,0,0,20,0,20,344.0
Melissa,2017,FEMALE,0,0,21,0,21,334.0
Melody,2017,FEMALE,54,39,51,0,144,109.0
Mia,2017,FEMALE,316,168,1000,536,2020,3.0
Michaela,2017,FEMALE,0,0,0,10,10,593.0
Michal,2017,FEMALE,0,0,0,11,11,543.0
Michelle,2017,FEMALE,56,108,120,112,396,44.0
Mikayla,2017,FEMALE,0,16,0,0,16,391.0
Mila,2017,FEMALE,76,40,200,300,616,27.0
Milana,2017,FEMALE,0,0,0,21,21,334.0
Milani,2017,FEMALE,0,26,34,0,60,200.0
Milania,2017,FEMALE,0,0,0,11,11,543.0
Millie,2017,FEMALE,0,0,0,11,11,543.0
Mina,2017,FEMALE,0,0,0,10,10,593.0
Mindy,2017,FEMALE,0,0,0,27,27,278.0
Mira,2017,FEMALE,0,0,0,23,23,310.0
Miracle,2017,FEMALE,0,20,0,0,20,344.0
Miranda,2017,FEMALE,0,0,13,0,13,463.0
Miriam,2017,FEMALE,0,0,0,161,161,98.0
Molly,2017,FEMALE,0,0,0,30,30,264.0
Morgan,2017,FEMALE,0,30,0,30,60,200.0
Mya,2017,FEMALE,0,28,36,0,64,194.0
Myra,2017,FEMALE,11,0,0,0,11,543.0
Nadia,2017,FEMALE,0,0,0,11,11,543.0
Nala,2017,FEMALE,0,11,0,0,11,543.0
Naomi,2017,FEMALE,60,132,104,188,484,36.0
Nashla,2017,FEMALE,0,0,14,0,14,434.0
Nashly,2017,FEMALE,0,0,13,0,13,463.0
Natalia,2017,FEMALE,0,0,56,38,94,143.0
Natalie,2017,FEMALE,63,0,93,123,279,68.0
Nathalia,2017,FEMALE,0,0,12,0,12,499.0
Nathalie,2017,FEMALE,0,0,16,0,16,391.0
Nava,2017,FEMALE,0,0,0,12,12,499.0
Nayeli,2017,FEMALE,0,0,13,0,13,463.0
Nayla,2017,FEMALE,0,0,10,0,10,593.0
Nechama,2017,FEMALE,0,0,0,24,24,300.0
Nevaeh,2017,FEMALE,0,56,30,0,86,155.0
Nia,2017,FEMALE,0,16,0,0,16,391.0
Nicole,2017,FEMALE,48,0,120,96,264,70.0
Nina,2017,FEMALE,22,0,0,70,92,144.0
Noa,2017,FEMALE,0,0,0,43,43,244.0
Noelle,2017,FEMALE,0,0,0,11,11,543.0
Noor,2017,FEMALE,34,0,0,34,68,182.0
Nora,2017,FEMALE,24,0,0,122,146,108.0
Norah,2017,FEMALE,24,0,0,20,44,239.0
Nova,2017,FEMALE,0,32,34,0,66,187.0
Nusrat,2017,FEMALE,11,0,0,0,11,543.0
Nyla,2017,FEMALE,0,58,24,0,82,161.0
Nylah,2017,FEMALE,0,24,0,0,24,300.0
Olive,2017,FEMALE,0,0,0,25,25,287.0
Olivia,2017,FEMALE,544,184,392,912,2032,2.0
Oumou,2017,FEMALE,0,19,0,0,19,360.0
Paige,2017,FEMALE,0,44,0,24,68,182.0
Paris,2017,FEMALE,0,32,20,0,52,212.0
Parker,2017,FEMALE,0,0,0,18,18,366.0
Pearl,2017,FEMALE,0,0,0,20,20,344.0
Penelope,2017,FEMALE,64,52,208,332,656,24.0
Perel,2017,FEMALE,0,0,0,12,12,499.0
Perl,2017,FEMALE,0,0,0,16,16,391.0
Perry,2017,FEMALE,0,0,0,14,14,434.0
Pessy,2017,FEMALE,0,0,0,24,24,300.0
Peyton,2017,FEMALE,0,75,45,39,159,100.0
Phoebe,2017,FEMALE,36,0,0,28,64,194.0
Phoenix,2017,FEMALE,0,18,0,0,18,366.0
Piper,2017,FEMALE,0,0,0,13,13,463.0
Poppy,2017,FEMALE,0,0,0,11,11,543.0
Priscilla,2017,FEMALE,0,0,13,0,13,463.0
Queenie,2017,FEMALE,13,0,0,0,13,463.0
Quinn,2017,FEMALE,0,0,0,24,24,300.0
Rachel,2017,FEMALE,54,0,63,495,612,28.0
Rahaf,2017,FEMALE,0,0,0,12,12,499.0
Raizel,2017,FEMALE,0,0,0,14,14,434.0
Raizy,2017,FEMALE,0,0,0,81,81,164.0
Raquel,2017,FEMALE,0,0,0,14,14,434.0
Raya,2017,FEMALE,0,0,0,11,11,543.0
Rayna,2017,FEMALE,10,0,0,0,10,593.0
Reagan,2017,FEMALE,0,0,0,12,12,499.0
Rebecca,2017,FEMALE,39,0,51,144,234,74.0
Reem,2017,FEMALE,0,0,0,10,10,593.0
Reese,2017,FEMALE,0,0,0,12,12,499.0
Reizy,2017,FEMALE,0,0,0,10,10,593.0
Renata,2017,FEMALE,0,0,10,0,10,593.0
Riley,2017,FEMALE,80,168,196,268,712,23.0
Rivka,2017,FEMALE,0,0,0,139,139,112.0
Rivkah,2017,FEMALE,0,0,0,11,11,543.0
Rivky,2017,FEMALE,0,0,0,66,66,187.0
Riya,2017,FEMALE,12,0,0,0,12,499.0
Rochel,2017,FEMALE,0,0,0,28,28,272.0
Roizy,2017,FEMALE,0,0,0,11,11,543.0
Rose,2017,FEMALE,0,0,0,35,35,255.0
Rowan,2017,FEMALE,0,0,0,16,16,391.0
Royalty,2017,FEMALE,0,12,0,0,12,499.0
Ruby,2017,FEMALE,0,0,46,112,158,101.0
Ruchel,2017,FEMALE,0,0,0,14,14,434.0
Ruchy,2017,FEMALE,0,0,0,14,14,434.0
Ruth,2017,FEMALE,0,0,0,22,22,322.0
Ryan,2017,FEMALE,0,0,0,16,16,391.0
Rylee,2017,FEMALE,0,26,26,0,52,212.0
Sabiha,2017,FEMALE,12,0,0,0,12,499.0
Sabina,2017,FEMALE,0,0,0,12,12,499.0
Sabrina,2017,FEMALE,0,0,24,38,62,198.0
Sadie,2017,FEMALE,0,0,22,96,118,120.0
Safa,2017,FEMALE,12,0,0,0,12,499.0
Sage,2017,FEMALE,0,0,0,16,16,391.0
Salma,2017,FEMALE,0,0,0,14,14,434.0
Sama,2017,FEMALE,0,0,0,12,12,499.0
Samantha,2017,FEMALE,57,0,243,114,414,42.0
Samara,2017,FEMALE,0,0,28,0,28,272.0
Samira,2017,FEMALE,0,0,28,26,54,211.0
Saoirse,2017,FEMALE,0,0,0,10,10,593.0
Sara,2017,FEMALE,54,0,54,369,477,38.0
Sarah,2017,FEMALE,128,108,232,760,1228,9.0
Sarai,2017,FEMALE,0,28,64,0,92,144.0
Sariah,2017,FEMALE,0,13,0,0,13,463.0
Sasha,2017,FEMALE,0,0,38,40,78,169.0
Savannah,2017,FEMALE,0,132,63,54,249,73.0
Scarlet,2017,FEMALE,0,0,13,0,13,463.0
Scarlett,2017,FEMALE,0,0,194,104,298,65.0
Selena,2017,FEMALE,24,0,24,0,48,226.0
Serena,2017,FEMALE,13,0,0,0,13,463.0
Serenity,2017,FEMALE,0,74,50,0,124,118.0
Sevyn,2017,FEMALE,0,12,0,0,12,499.0
Shaina,2017,FEMALE,0,0,0,14,14,434.0
Shaindel,2017,FEMALE,0,0,0,12,12,499.0
Shaindy,2017,FEMALE,0,0,0,56,56,207.0
Sherlyn,2017,FEMALE,0,0,21,0,21,334.0
Shevy,2017,FEMALE,0,0,0,11,11,543.0
Shifra,2017,FEMALE,0,0,0,22,22,322.0
Shira,2017,FEMALE,0,0,0,14,14,434.0
Shoshana,2017,FEMALE,0,0,0,20,20,344.0
Siena,2017,FEMALE,0,0,0,23,23,310.0
Sienna,2017,FEMALE,0,0,26,92,118,120.0
Sima,2017,FEMALE,0,0,0,18,18,366.0
Simone,2017,FEMALE,0,0,0,14,14,434.0
Skye,2017,FEMALE,0,10,0,0,10,593.0
Skyla,2017,FEMALE,0,0,10,0,10,593.0
Skylah,2017,FEMALE,0,12,0,0,12,499.0
Skylar,2017,FEMALE,0,225,69,72,366,50.0
Skyler,2017,FEMALE,0,11,0,0,11,543.0
Sloane,2017,FEMALE,0,0,0,39,39,251.0
Sofia,2017,FEMALE,90,0,438,330,858,20.0
Sophia,2017,FEMALE,344,60,856,668,1928,4.0
Sophie,2017,FEMALE,84,0,39,225,348,56.0
Stacy,2017,FEMALE,0,0,13,0,13,463.0
Stella,2017,FEMALE,63,0,72,228,363,51.0
Stephanie,2017,FEMALE,28,0,54,0,82,161.0
Summer,2017,FEMALE,0,18,0,0,18,366.0
Sury,2017,FEMALE,0,0,0,36,36,254.0
Sydney,2017,FEMALE,0,26,0,62,88,151.0
Syeda,2017,FEMALE,11,0,0,0,11,543.0
Sylvia,2017,FEMALE,13,0,0,0,13,463.0
Sylvie,2017,FEMALE,0,0,0,15,15,414.0
Talia,2017,FEMALE,0,0,0,41,41,246.0
Tamar,2017,FEMALE,0,0,0,12,12,499.0
Taylor,2017,FEMALE,0,84,30,42,156,102.0
Teagan,2017,FEMALE,0,0,0,11,11,543.0
Tehila,2017,FEMALE,0,0,0,15,15,414.0
Tenzin,2017,FEMALE,24,0,0,0,24,300.0
Tessa,2017,FEMALE,0,0,0,19,19,360.0
Thea,2017,FEMALE,0,0,0,12,12,499.0
Theodora,2017,FEMALE,0,0,0,12,12,499.0
Tiffany,2017,FEMALE,56,0,20,0,76,172.0
Toba,2017,FEMALE,0,0,0,13,13,463.0
Toby,2017,FEMALE,0,0,0,46,46,235.0
Tori,2017,FEMALE,0,22,0,0,22,322.0
Trinity,2017,FEMALE,0,10,0,0,10,593.0
Tzipora,2017,FEMALE,0,0,0,14,14,434.0
Tziporah,2017,FEMALE,0,0,0,15,15,414.0
Tzippy,2017,FEMALE,0,0,0,10,10,593.0
Tzirel,2017,FEMALE,0,0,0,12,12,499.0
Valentina,2017,FEMALE,0,0,248,120,368,49.0
Valeria,2017,FEMALE,0,0,40,0,40,248.0
Valerie,2017,FEMALE,24,0,130,0,154,103.0
Valery,2017,FEMALE,0,0,10,0,10,593.0
Vanessa,2017,FEMALE,20,0,30,0,50,220.0
Vera,2017,FEMALE,20,0,0,46,66,187.0
Veronica,2017,FEMALE,0,0,0,14,14,434.0
Vicky,2017,FEMALE,13,0,0,0,13,463.0
Victoria,2017,FEMALE,96,108,512,284,1000,14.0
Violet,2017,FEMALE,0,0,42,70,112,122.0
Vivian,2017,FEMALE,42,0,0,98,140,110.0
Vivienne,2017,FEMALE,0,0,0,29,29,266.0
Willa,2017,FEMALE,0,0,0,20,20,344.0
Willow,2017,FEMALE,0,0,0,13,13,463.0
Winnie,2017,FEMALE,13,0,0,0,13,463.0
Wynter,2017,FEMALE,0,10,0,0,10,593.0
Ximena,2017,FEMALE,0,0,29,0,29,266.0
Yael,2017,FEMALE,0,0,0,20,20,344.0
Yamileth,2017,FEMALE,0,0,11,0,11,543.0
Yaretzi,2017,FEMALE,0,0,29,0,29,266.0
Yasmina,2017,FEMALE,0,0,0,12,12,499.0
Yasmine,2017,FEMALE,0,0,0,10,10,593.0
Yehudis,2017,FEMALE,0,0,0,19,19,360.0
Yides,2017,FEMALE,0,0,0,25,25,287.0
Yitty,2017,FEMALE,0,0,0,52,52,212.0
Yocheved,2017,FEMALE,0,0,0,20,20,344.0
Zahra,2017,FEMALE,10,0,0,0,10,593.0
Zainab,2017,FEMALE,40,0,0,0,40,248.0
Zaniyah,2017,FEMALE,0,10,0,0,10,593.0
Zara,2017,FEMALE,84,64,52,56,256,71.0
Zelda,2017,FEMALE,0,0,0,10,10,593.0
Zissy,2017,FEMALE,0,0,0,30,30,264.0
Zoe,2017,FEMALE,132,140,348,312,932,17.0
Zoey,2017,FEMALE,108,112,140,96,456,39.0
Zoya,2017,FEMALE,11,0,0,0,11,543.0
Zuri,2017,FEMALE,0,34,0,0,34,256.0
Aahil,2017,MALE,11,0,0,0,11,502.0
Aarav,2017,MALE,20,0,0,0,20,335.0
Aaron,2017,MALE,188,152,684,272,1296,20.0
Aayan,2017,MALE,14,0,0,0,14,437.0
Abdiel,2017,MALE,0,0,34,0,34,256.0
Abdoul,2017,MALE,0,10,0,0,10,542.0
Abdoulaye,2017,MALE,0,16,0,0,16,391.0
Abdul,2017,MALE,21,0,0,0,21,325.0
Abdullah,2017,MALE,46,0,0,28,74,188.0
Abe,2017,MALE,0,0,0,11,11,502.0
Abel,2017,MALE,0,0,22,0,22,313.0
Abraham,2017,MALE,0,0,52,274,326,82.0
Abrar,2017,MALE,13,0,0,0,13,451.0
Ace,2017,MALE,0,13,0,0,13,451.0
Adam,2017,MALE,140,80,160,676,1056,26.0
Aden,2017,MALE,0,11,0,0,11,502.0
Adiel,2017,MALE,0,0,12,0,12,473.0
Adonis,2017,MALE,0,46,48,0,94,168.0
Adrian,2017,MALE,116,44,516,176,852,34.0
Adriel,2017,MALE,0,0,35,0,35,255.0
Aharon,2017,MALE,0,0,0,16,16,391.0
Ahmed,2017,MALE,28,0,0,64,92,171.0
Aidan,2017,MALE,81,0,54,120,255,100.0
Aiden,2017,MALE,516,428,576,292,1812,11.0
Akiva,2017,MALE,0,0,0,21,21,325.0
Alan,2017,MALE,78,0,222,45,345,76.0
Albert,2017,MALE,36,0,39,63,138,140.0
Alejandro,2017,MALE,0,0,45,0,45,231.0
Alex,2017,MALE,116,44,160,88,408,69.0
Alexander,2017,MALE,156,156,584,728,1624,15.0
Alexis,2017,MALE,0,0,27,0,27,278.0
Ali,2017,MALE,66,42,0,177,285,93.0
Allan,2017,MALE,0,0,11,0,11,502.0
Allen,2017,MALE,44,0,32,0,76,184.0
Alpha,2017,MALE,0,12,0,0,12,473.0
Alston,2017,MALE,18,0,0,0,18,363.0
Alvin,2017,MALE,17,0,0,0,17,376.0
Amadou,2017,MALE,0,12,0,0,12,473.0
Amari,2017,MALE,0,39,0,0,39,242.0
Ameer,2017,MALE,0,0,0,14,14,437.0
Amir,2017,MALE,0,282,75,123,480,63.0
Amrom,2017,MALE,0,0,0,12,12,473.0
Anderson,2017,MALE,0,0,32,28,60,204.0
Andre,2017,MALE,0,17,0,0,17,376.0
Andres,2017,MALE,0,0,26,0,26,286.0
Andrew,2017,MALE,108,84,224,308,724,41.0
Andy,2017,MALE,72,0,26,0,98,161.0
Angel,2017,MALE,0,0,161,0,161,129.0
Angelo,2017,MALE,0,0,0,20,20,335.0
Anson,2017,MALE,21,0,0,0,21,325.0
Anthony,2017,MALE,76,192,500,392,1160,24.0
Antonio,2017,MALE,0,0,40,60,100,159.0
Arham,2017,MALE,33,0,0,0,33,260.0
Ari,2017,MALE,0,0,0,44,44,233.0
Ariel,2017,MALE,0,0,38,58,96,164.0
Arjun,2017,MALE,20,0,0,0,20,335.0
Arlo,2017,MALE,0,0,0,19,19,349.0
Armando,2017,MALE,0,0,14,0,14,437.0
Armani,2017,MALE,0,0,13,0,13,451.0
Aron,2017,MALE,0,0,0,65,65,200.0
Arthur,2017,MALE,24,0,0,90,114,151.0
Aryan,2017,MALE,25,0,0,0,25,295.0
Aryeh,2017,MALE,0,0,0,32,32,263.0
Asher,2017,MALE,64,112,40,360,576,49.0
Ashton,2017,MALE,0,44,34,0,78,181.0
August,2017,MALE,0,30,0,60,90,172.0
Augustus,2017,MALE,0,0,0,10,10,542.0
Austin,2017,MALE,212,120,208,76,616,47.0
Avery,2017,MALE,0,44,42,0,86,176.0
Avraham,2017,MALE,0,0,0,55,55,216.0
Avrohom,2017,MALE,0,0,0,23,23,304.0
Avrum,2017,MALE,0,0,0,17,17,376.0
Axel,2017,MALE,0,0,122,34,156,130.0
Ayaan,2017,MALE,45,0,0,0,45,231.0
Ayan,2017,MALE,22,0,0,0,22,313.0
Ayden,2017,MALE,63,93,159,0,315,87.0
Aydin,2017,MALE,10,0,0,0,10,542.0
Baruch,2017,MALE,0,0,0,11,11,502.0
Ben,2017,MALE,0,0,0,20,20,335.0
Benjamin,2017,MALE,132,92,268,772,1264,21.0
Bennett,2017,MALE,0,0,0,19,19,349.0
Benson,2017,MALE,11,0,0,0,11,502.0
Benzion,2017,MALE,0,0,0,16,16,391.0
Binyamin,2017,MALE,0,0,0,11,11,502.0
Binyomin,2017,MALE,0,0,0,16,16,391.0
Blake,2017,MALE,0,0,0,15,15,412.0
Bodhi,2017,MALE,0,0,0,10,10,542.0
Boubacar,2017,MALE,0,11,0,0,11,502.0
Bradley,2017,MALE,0,0,16,0,16,391.0
Brandon,2017,MALE,120,72,236,68,496,62.0
Brayan,2017,MALE,0,0,17,0,17,376.0
Brayden,2017,MALE,0,0,50,22,72,190.0
Brendan,2017,MALE,0,0,0,12,12,473.0
Brian,2017,MALE,81,0,51,30,162,128.0
Brody,2017,MALE,0,0,0,13,13,451.0
Brooks,2017,MALE,0,0,0,13,13,451.0
Bruno,2017,MALE,0,0,11,0,11,502.0
Bryan,2017,MALE,69,39,141,0,249,101.0
Bryant,2017,MALE,0,0,12,0,12,473.0
Bryce,2017,MALE,0,76,36,0,112,152.0
Bryson,2017,MALE,0,92,56,0,148,134.0
Byron,2017,MALE,0,0,10,0,10,542.0
Caiden,2017,MALE,0,16,0,0,16,391.0
Cairo,2017,MALE,0,19,0,0,19,349.0
Caleb,2017,MALE,76,108,196,96,476,65.0
Calvin,2017,MALE,0,0,0,19,19,349.0
Cameron,2017,MALE,40,200,108,124,472,66.0
Camilo,2017,MALE,0,0,10,0,10,542.0
Carlos,2017,MALE,0,0,77,0,77,183.0
Carmelo,2017,MALE,0,0,10,0,10,542.0
Carson,2017,MALE,34,20,0,0,54,218.0
Carter,2017,MALE,0,231,69,90,390,74.0
Cayden,2017,MALE,0,11,0,0,11,502.0
Cesar,2017,MALE,0,0,22,0,22,313.0
Chaim,2017,MALE,0,0,0,165,165,127.0
Chance,2017,MALE,0,16,0,0,16,391.0
Charles,2017,MALE,66,0,39,441,546,56.0
Charlie,2017,MALE,0,0,0,33,33,260.0
Chase,2017,MALE,0,171,51,84,306,89.0
Cheskel,2017,MALE,0,0,0,12,12,473.0
Chesky,2017,MALE,0,0,0,10,10,542.0
Chris,2017,MALE,0,0,19,0,19,349.0
Christian,2017,MALE,52,216,260,224,752,39.0
Christopher,2017,MALE,72,176,436,300,984,30.0
Clark,2017,MALE,0,0,0,12,12,473.0
Cole,2017,MALE,0,0,0,34,34,256.0
Colin,2017,MALE,0,0,0,19,19,349.0
Connor,2017,MALE,60,33,0,183,276,94.0
Conor,2017,MALE,0,0,0,23,23,304.0
Cooper,2017,MALE,0,0,0,26,26,286.0
Corey,2017,MALE,0,11,0,0,11,502.0
Cristian,2017,MALE,0,0,31,0,31,265.0
Cyrus,2017,MALE,24,0,0,20,44,233.0
Dallas,2017,MALE,0,11,0,0,11,502.0
Damian,2017,MALE,0,0,90,22,112,152.0
Damien,2017,MALE,0,0,10,0,10,542.0
Daniel,2017,MALE,248,168,632,780,1828,9.0
Danny,2017,MALE,10,0,0,0,10,542.0
Dante,2017,MALE,0,0,15,0,15,412.0
Dariel,2017,MALE,0,0,20,0,20,335.0
Darren,2017,MALE,24,0,0,0,24,299.0
David,2017,MALE,108,264,528,1128,2028,5.0
Dean,2017,MALE,20,0,0,64,84,178.0
Declan,2017,MALE,0,0,0,21,21,325.0
Dereck,2017,MALE,0,0,10,0,10,542.0
Derek,2017,MALE,39,0,129,30,198,114.0
Desmond,2017,MALE,0,0,0,14,14,437.0
Devin,2017,MALE,15,0,0,0,15,412.0
Diego,2017,MALE,0,0,56,0,56,214.0
Dominic,2017,MALE,0,30,69,114,213,112.0
Dominick,2017,MALE,0,0,20,32,52,220.0
Dov,2017,MALE,0,0,0,38,38,248.0
Dovid,2017,MALE,0,0,0,20,20,335.0
Duvid,2017,MALE,0,0,0,13,13,451.0
Dylan,2017,MALE,156,116,1148,344,1764,12.0
Ean,2017,MALE,0,0,18,0,18,363.0
Eason,2017,MALE,39,0,0,0,39,242.0
Eden,2017,MALE,15,0,0,0,15,412.0
Edgar,2017,MALE,0,0,14,0,14,437.0
Eduardo,2017,MALE,0,0,14,0,14,437.0
Edward,2017,MALE,45,0,96,117,258,98.0
Edwin,2017,MALE,0,0,30,0,30,267.0
Efraim,2017,MALE,0,0,0,21,21,325.0
Eitan,2017,MALE,0,0,0,15,15,412.0
Eli,2017,MALE,40,84,168,408,700,42.0
Eliam,2017,MALE,0,0,20,0,20,335.0
Elian,2017,MALE,0,0,30,0,30,267.0
Elias,2017,MALE,0,0,214,76,290,92.0
Eliezer,2017,MALE,0,0,0,48,48,226.0
Elijah,2017,MALE,72,376,340,120,908,33.0
Elimelech,2017,MALE,0,0,0,17,17,376.0
Eliyahu,2017,MALE,0,0,0,27,27,278.0
Elliot,2017,MALE,24,0,0,80,104,157.0
Elliott,2017,MALE,0,0,0,26,26,286.0
Ellis,2017,MALE,0,0,0,26,26,286.0
Eluzer,2017,MALE,0,0,0,11,11,502.0
Emanuel,2017,MALE,0,0,38,22,60,204.0
Emerson,2017,MALE,0,0,0,14,14,437.0
Emil,2017,MALE,0,0,10,0,10,542.0
Emiliano,2017,MALE,0,0,18,0,18,363.0
Emilio,2017,MALE,0,0,24,0,24,299.0
Emmanuel,2017,MALE,0,52,102,0,154,131.0
Emmett,2017,MALE,0,0,0,15,15,412.0
Enrique,2017,MALE,0,0,11,0,11,502.0
Enzo,2017,MALE,0,0,52,36,88,175.0
Eric,2017,MALE,183,0,75,60,318,86.0
Erick,2017,MALE,0,0,60,0,60,204.0
Erik,2017,MALE,0,0,0,11,11,502.0
Ethan,2017,MALE,584,400,716,460,2160,4.0
Evan,2017,MALE,232,64,152,152,600,48.0
Everett,2017,MALE,0,0,0,26,26,286.0
Eyad,2017,MALE,0,0,0,17,17,376.0
Ezekiel,2017,MALE,0,48,50,0,98,161.0
Ezequiel,2017,MALE,0,0,15,0,15,412.0
Ezra,2017,MALE,0,60,87,189,336,79.0
Ezriel,2017,MALE,0,0,0,14,14,437.0
Felipe,2017,MALE,0,0,10,0,10,542.0
Felix,2017,MALE,38,0,0,60,98,161.0
Fernando,2017,MALE,0,0,16,0,16,391.0
Finley,2017,MALE,0,0,0,14,14,437.0
Finn,2017,MALE,0,0,0,39,39,242.0
Fishel,2017,MALE,0,0,0,12,12,473.0
Francis,2017,MALE,0,0,0,19,19,349.0
Francisco,2017,MALE,0,0,24,0,24,299.0
Frank,2017,MALE,0,0,0,20,20,335.0
Gabriel,2017,MALE,88,108,412,392,1000,29.0
Gael,2017,MALE,0,0,76,0,76,184.0
Gavin,2017,MALE,75,0,36,72,183,120.0
Gavriel,2017,MALE,0,0,0,16,16,391.0
George,2017,MALE,54,0,72,213,339,77.0
Gianni,2017,MALE,0,13,0,0,13,451.0
Gideon,2017,MALE,0,0,0,11,11,502.0
Giovanni,2017,MALE,0,48,105,81,234,107.0
Graham,2017,MALE,0,0,0,18,18,363.0
Grant,2017,MALE,0,0,0,18,18,363.0
Grayson,2017,MALE,44,64,152,136,396,71.0
Gregory,2017,MALE,0,0,0,15,15,412.0
Greyson,2017,MALE,0,54,75,39,168,126.0
Guy,2017,MALE,0,0,0,11,11,502.0
Hamza,2017,MALE,26,0,0,44,70,195.0
Harrison,2017,MALE,38,0,0,104,142,137.0
Harry,2017,MALE,20,0,0,40,60,204.0
Harvey,2017,MALE,0,0,0,15,15,412.0
Hassan,2017,MALE,13,0,0,0,13,451.0
Hayden,2017,MALE,28,22,0,0,50,224.0
Hector,2017,MALE,0,0,21,0,21,325.0
Henry,2017,MALE,138,0,117,591,846,35.0
Hershel,2017,MALE,0,0,0,19,19,349.0
Hershy,2017,MALE,0,0,0,32,32,263.0
Hillel,2017,MALE,0,0,0,12,12,473.0
Hudson,2017,MALE,48,0,0,106,154,131.0
Hugo,2017,MALE,0,0,24,50,74,188.0
Hunter,2017,MALE,44,152,148,100,444,68.0
Ian,2017,MALE,114,0,330,63,507,61.0
Ibrahim,2017,MALE,129,126,0,60,315,87.0
Ibrahima,2017,MALE,0,17,0,0,17,376.0
Iker,2017,MALE,0,0,30,0,30,267.0
Imran,2017,MALE,0,0,0,18,18,363.0
Isaac,2017,MALE,128,60,384,464,1036,27.0
Isaiah,2017,MALE,0,189,168,36,393,73.0
Isaias,2017,MALE,0,0,12,0,12,473.0
Ishaan,2017,MALE,10,0,0,0,10,542.0
Ismael,2017,MALE,0,0,27,0,27,278.0
Israel,2017,MALE,0,57,48,72,177,124.0
Issac,2017,MALE,0,0,13,0,13,451.0
Ivan,2017,MALE,141,0,96,33,270,96.0
Jace,2017,MALE,0,104,80,0,184,119.0
Jack,2017,MALE,48,0,48,585,681,46.0
Jackson,2017,MALE,96,68,68,300,532,58.0
Jacob,2017,MALE,164,152,1160,1056,2532,3.0
Jad,2017,MALE,0,0,0,17,17,376.0
Jaden,2017,MALE,78,90,75,0,243,104.0
Jadiel,2017,MALE,0,0,43,0,43,237.0
Jael,2017,MALE,0,0,10,0,10,542.0
Jaiden,2017,MALE,0,38,24,0,62,203.0
Jaime,2017,MALE,0,0,15,0,15,412.0
Jake,2017,MALE,0,0,62,78,140,139.0
Jamel,2017,MALE,0,13,0,0,13,451.0
James,2017,MALE,180,116,336,852,1484,18.0
Jameson,2017,MALE,0,0,0,10,10,542.0
Jamir,2017,MALE,0,13,0,0,13,451.0
Jared,2017,MALE,0,0,23,0,23,304.0
Jariel,2017,MALE,0,0,15,0,15,412.0
Jasiah,2017,MALE,0,10,0,0,10,542.0
Jason,2017,MALE,212,124,208,140,684,43.0
Jasper,2017,MALE,116,0,0,36,152,133.0
Javier,2017,MALE,0,0,23,0,23,304.0
Jax,2017,MALE,0,0,16,0,16,391.0
Jaxon,2017,MALE,0,57,69,78,204,113.0
Jaxson,2017,MALE,0,36,51,51,138,140.0
Jayce,2017,MALE,0,78,100,0,178,122.0
Jayceon,2017,MALE,0,27,0,0,27,278.0
Jaycob,2017,MALE,0,0,12,0,12,473.0
Jayden,2017,MALE,544,300,976,104,1924,7.0
Jaylen,2017,MALE,0,34,24,0,58,210.0
Jean,2017,MALE,0,0,13,0,13,451.0
Jefferson,2017,MALE,0,0,22,0,22,313.0
Jeffrey,2017,MALE,14,0,0,0,14,437.0
Jeremiah,2017,MALE,0,198,138,0,336,79.0
Jeremy,2017,MALE,68,0,148,0,216,110.0
Jerry,2017,MALE,18,0,0,0,18,363.0
Jesse,2017,MALE,0,0,0,17,17,376.0
Jesus,2017,MALE,0,0,34,0,34,256.0
Jimmy,2017,MALE,12,0,0,0,12,473.0
Joaquin,2017,MALE,0,0,12,0,12,473.0
Joel,2017,MALE,0,87,174,78,339,77.0
Johan,2017,MALE,0,0,27,0,27,278.0
John,2017,MALE,48,52,260,612,972,31.0
Johnny,2017,MALE,0,0,10,0,10,542.0
Jonah,2017,MALE,0,33,42,105,180,121.0
Jonas,2017,MALE,0,0,21,0,21,325.0
Jonathan,2017,MALE,140,136,292,224,792,37.0
Jordan,2017,MALE,64,168,184,136,552,54.0
Jorge,2017,MALE,0,0,20,0,20,335.0
Jose,2017,MALE,0,0,90,0,90,172.0
Joseph,2017,MALE,96,124,480,1116,1816,10.0
Joshua,2017,MALE,112,320,544,252,1228,22.0
Josiah,2017,MALE,0,273,246,30,549,55.0
Josue,2017,MALE,0,0,39,0,39,242.0
Joziah,2017,MALE,0,0,13,0,13,451.0
Juan,2017,MALE,0,0,58,0,58,210.0
Judah,2017,MALE,0,0,0,28,28,274.0
Jude,2017,MALE,0,0,0,27,27,278.0
Julian,2017,MALE,80,84,316,304,784,38.0
Julien,2017,MALE,0,0,14,0,14,437.0
Julius,2017,MALE,0,20,48,0,68,197.0
Justice,2017,MALE,0,19,0,0,19,349.0
Justin,2017,MALE,192,136,316,88,732,40.0
Kabir,2017,MALE,10,0,0,0,10,542.0
Kaden,2017,MALE,0,17,0,0,17,376.0
Kai,2017,MALE,108,112,44,72,336,79.0
Kaiden,2017,MALE,0,94,26,0,120,147.0
Kaleb,2017,MALE,0,66,28,0,94,168.0
Kamari,2017,MALE,0,19,0,0,19,349.0
Kameron,2017,MALE,0,22,0,0,22,313.0
Kamren,2017,MALE,0,11,0,0,11,502.0
Kareem,2017,MALE,0,12,0,0,12,473.0
Karter,2017,MALE,0,36,0,0,36,253.0
Kayden,2017,MALE,63,150,153,0,366,75.0
Kayson,2017,MALE,0,0,10,0,10,542.0
Kendrick,2017,MALE,0,0,10,0,10,542.0
Kenneth,2017,MALE,0,20,32,0,52,220.0
Kenny,2017,MALE,0,0,12,0,12,473.0
Kevin,2017,MALE,224,64,284,112,684,43.0
Khalil,2017,MALE,0,15,0,0,15,412.0
Kian,2017,MALE,0,0,0,11,11,502.0
Kieran,2017,MALE,0,0,0,15,15,412.0
Kimi,2017,MALE,15,0,0,0,15,412.0
King,2017,MALE,0,124,64,0,188,117.0
Kingsley,2017,MALE,19,0,0,0,19,349.0
Kingston,2017,MALE,0,12,0,0,12,473.0
Kyle,2017,MALE,99,45,45,0,189,116.0
Kyrie,2017,MALE,0,114,24,0,138,140.0
Kyson,2017,MALE,20,0,0,0,20,335.0
Landon,2017,MALE,0,30,72,84,186,118.0
Lazer,2017,MALE,0,0,0,15,15,412.0
Legend,2017,MALE,0,22,0,0,22,313.0
Leo,2017,MALE,144,0,75,465,684,43.0
Leon,2017,MALE,51,0,36,150,237,106.0
Leonard,2017,MALE,0,0,0,11,11,502.0
Leonardo,2017,MALE,33,0,216,147,396,71.0
Leonel,2017,MALE,0,0,16,0,16,391.0
Lev,2017,MALE,0,0,0,16,16,391.0
Levi,2017,MALE,0,66,45,189,300,90.0
Liam,2017,MALE,332,452,1628,476,2888,1.0
Lincoln,2017,MALE,0,0,0,20,20,335.0
Lipa,2017,MALE,0,0,0,26,26,286.0
Logan,2017,MALE,228,288,592,324,1432,19.0
Lorenzo,2017,MALE,0,0,40,56,96,164.0
Louis,2017,MALE,78,0,33,123,234,107.0
Luca,2017,MALE,0,0,50,146,196,115.0
Lucas,2017,MALE,500,88,888,448,1924,7.0
Luis,2017,MALE,0,0,76,0,76,184.0
Luka,2017,MALE,0,0,0,14,14,437.0
Lukas,2017,MALE,0,0,40,32,72,190.0
Luke,2017,MALE,76,48,72,344,540,57.0
Maddox,2017,MALE,0,0,10,0,10,542.0
Maison,2017,MALE,0,28,24,0,52,220.0
Major,2017,MALE,0,11,0,0,11,502.0
Malachi,2017,MALE,0,44,0,0,44,233.0
Malik,2017,MALE,0,20,0,28,48,226.0
Mamadou,2017,MALE,0,27,0,0,27,278.0
Manuel,2017,MALE,0,0,22,0,22,313.0
Marc,2017,MALE,0,0,0,18,18,363.0
Marcel,2017,MALE,0,0,0,12,12,473.0
Marco,2017,MALE,0,0,12,0,12,473.0
Marcos,2017,MALE,0,0,19,0,19,349.0
Marcus,2017,MALE,84,60,44,68,256,99.0
Mario,2017,MALE,0,0,13,0,13,451.0
Mark,2017,MALE,0,20,0,116,136,145.0
Martin,2017,MALE,0,0,38,58,96,164.0
Marvin,2017,MALE,0,0,14,0,14,437.0
Mason,2017,MALE,268,416,584,308,1576,16.0
Mateo,2017,MALE,0,0,276,46,322,83.0
Mathew,2017,MALE,0,0,18,0,18,363.0
Mathias,2017,MALE,0,0,29,0,29,271.0
Matias,2017,MALE,0,0,58,0,58,210.0
Matteo,2017,MALE,0,0,84,58,142,137.0
Matthew,2017,MALE,228,148,1104,464,1944,6.0
Matthias,2017,MALE,0,0,11,0,11,502.0
Maverick,2017,MALE,0,0,11,0,11,502.0
Max,2017,MALE,102,0,87,291,480,63.0
Maxim,2017,MALE,0,0,0,17,17,376.0
Maximilian,2017,MALE,0,0,0,28,28,274.0
Maximiliano,2017,MALE,0,0,16,0,16,391.0
Maximus,2017,MALE,0,0,20,0,20,335.0
Maxwell,2017,MALE,22,0,0,122,144,136.0
Mayer,2017,MALE,0,0,0,22,22,313.0
Md,2017,MALE,20,0,0,0,20,335.0
Mechel,2017,MALE,0,0,0,12,12,473.0
Meir,2017,MALE,0,0,0,50,50,224.0
Mekhi,2017,MALE,0,12,0,0,12,473.0
Melvin,2017,MALE,0,0,11,0,11,502.0
Menachem,2017,MALE,0,0,0,96,96,164.0
Mendel,2017,MALE,0,0,0,42,42,238.0
Mendy,2017,MALE,0,0,0,23,23,304.0
Meshilem,2017,MALE,0,0,0,11,11,502.0
Messiah,2017,MALE,0,84,26,0,110,154.0
Micah,2017,MALE,22,96,0,0,118,149.0
Michael,2017,MALE,112,256,496,840,1704,13.0
Miguel,2017,MALE,0,0,39,0,39,242.0
Mike,2017,MALE,0,0,10,0,10,542.0
Milan,2017,MALE,0,0,22,0,22,313.0
Miles,2017,MALE,39,30,0,228,297,91.0
Milo,2017,MALE,0,0,0,26,26,286.0
Mohamed,2017,MALE,0,84,0,94,178,122.0
Mohammad,2017,MALE,60,0,0,0,60,204.0
Mohammed,2017,MALE,74,0,0,52,126,146.0
Moises,2017,MALE,0,0,29,0,29,271.0
Moishe,2017,MALE,0,0,0,17,17,376.0
Mordechai,2017,MALE,0,0,0,86,86,176.0
Moses,2017,MALE,0,0,0,23,23,304.0
Moshe,2017,MALE,0,0,0,223,223,109.0
Mouhamed,2017,MALE,0,10,0,0,10,542.0
Muhammad,2017,MALE,471,54,0,48,573,52.0
Musa,2017,MALE,23,0,0,0,23,304.0
Mustafa,2017,MALE,15,0,0,0,15,412.0
Myles,2017,MALE,0,12,0,0,12,473.0
Nachman,2017,MALE,0,0,0,11,11,502.0
Naftali,2017,MALE,0,0,0,28,28,274.0
Naftuli,2017,MALE,0,0,0,16,16,391.0
Nasir,2017,MALE,0,38,0,0,38,248.0
Nathan,2017,MALE,220,156,320,308,1004,28.0
Nathaniel,2017,MALE,48,120,184,224,576,49.0
Nelson,2017,MALE,0,0,12,0,12,473.0
Niam,2017,MALE,13,0,0,0,13,451.0
Nicholas,2017,MALE,92,96,268,488,944,32.0
Nico,2017,MALE,0,0,0,21,21,325.0
Nicolas,2017,MALE,0,0,112,62,174,125.0
Nikolas,2017,MALE,0,0,0,11,11,502.0
Noah,2017,MALE,208,592,1020,732,2552,2.0
Noam,2017,MALE,0,0,0,18,18,363.0
Noel,2017,MALE,0,0,28,0,28,274.0
Nolan,2017,MALE,60,52,60,88,260,97.0
Nuchem,2017,MALE,0,0,0,16,16,391.0
Oliver,2017,MALE,123,0,249,429,801,36.0
Omar,2017,MALE,0,48,57,135,240,105.0
Omari,2017,MALE,0,21,0,0,21,325.0
Oscar,2017,MALE,48,0,69,129,246,102.0
Otto,2017,MALE,0,0,0,10,10,542.0
Oumar,2017,MALE,0,10,0,0,10,542.0
Ousmane,2017,MALE,0,13,0,0,13,451.0
Owen,2017,MALE,120,0,69,219,408,69.0
Pablo,2017,MALE,0,0,17,0,17,376.0
Parker,2017,MALE,0,0,0,25,25,295.0
Patrick,2017,MALE,0,0,0,33,33,260.0
Paul,2017,MALE,0,0,0,22,22,313.0
Pedro,2017,MALE,0,0,17,0,17,376.0
Peter,2017,MALE,0,0,0,42,42,238.0
Philip,2017,MALE,0,0,0,19,19,349.0
Phoenix,2017,MALE,0,11,0,0,11,502.0
Pierce,2017,MALE,0,0,0,10,10,542.0
Pinchas,2017,MALE,0,0,0,31,31,265.0
Pinchus,2017,MALE,0,0,0,18,18,363.0
Preston,2017,MALE,24,0,0,32,56,214.0
Prince,2017,MALE,0,37,0,0,37,251.0
Princeton,2017,MALE,0,14,0,0,14,437.0
Quinn,2017,MALE,0,0,0,11,11,502.0
Rafael,2017,MALE,0,0,52,64,116,150.0
Ralph,2017,MALE,0,0,0,11,11,502.0
Raphael,2017,MALE,0,0,0,27,27,278.0
Rayan,2017,MALE,60,0,0,50,110,154.0
Raymond,2017,MALE,50,0,20,0,70,195.0
Rayyan,2017,MALE,15,0,0,0,15,412.0
Reid,2017,MALE,0,0,0,11,11,502.0
Rhys,2017,MALE,0,0,0,13,13,451.0
Ricardo,2017,MALE,0,0,11,0,11,502.0
Richard,2017,MALE,0,0,40,38,78,181.0
River,2017,MALE,0,0,0,16,16,391.0
Robert,2017,MALE,0,42,66,213,321,84.0
Roberto,2017,MALE,0,0,10,0,10,542.0
Rocco,2017,MALE,0,0,0,20,20,335.0
Rodrigo,2017,MALE,0,0,10,0,10,542.0
Roger,2017,MALE,0,0,12,0,12,473.0
Roman,2017,MALE,0,0,30,74,104,157.0
Ronan,2017,MALE,0,0,0,15,15,412.0
Rory,2017,MALE,0,0,0,10,10,542.0
Rowan,2017,MALE,0,0,0,16,16,391.0
Roy,2017,MALE,19,0,0,0,19,349.0
Ruben,2017,MALE,0,0,11,0,11,502.0
Ryan,2017,MALE,572,172,412,520,1676,14.0
Ryder,2017,MALE,0,0,0,15,15,412.0
Safwan,2017,MALE,11,0,0,0,11,502.0
Saifan,2017,MALE,12,0,0,0,12,473.0
Salvatore,2017,MALE,0,0,0,25,25,295.0
Sam,2017,MALE,0,0,0,38,38,248.0
Samir,2017,MALE,0,20,0,20,40,240.0
Samuel,2017,MALE,108,120,280,636,1144,25.0
Santiago,2017,MALE,0,0,65,0,65,200.0
Santino,2017,MALE,0,0,0,16,16,391.0
Saul,2017,MALE,0,0,20,34,54,218.0
Sawyer,2017,MALE,0,0,0,15,15,412.0
Sean,2017,MALE,36,33,0,69,138,140.0
Sebastian,2017,MALE,56,132,1012,332,1532,17.0
Selim,2017,MALE,0,0,0,11,11,502.0
Sergio,2017,MALE,0,0,11,0,11,502.0
Shalom,2017,MALE,0,0,0,13,13,451.0
Shane,2017,MALE,0,0,0,18,18,363.0
Shawn,2017,MALE,20,32,0,0,52,220.0
Shaya,2017,MALE,0,0,0,37,37,251.0
Shea,2017,MALE,0,0,0,16,16,391.0
Sheldon,2017,MALE,13,0,0,0,13,451.0
Shia,2017,MALE,0,0,0,34,34,256.0
Shimon,2017,MALE,0,0,0,94,94,168.0
Shloime,2017,MALE,0,0,0,13,13,451.0
Shloimy,2017,MALE,0,0,0,15,15,412.0
Shloma,2017,MALE,0,0,0,10,10,542.0
Shlome,2017,MALE,0,0,0,16,16,391.0
Shlomo,2017,MALE,0,0,0,68,68,197.0
Shmiel,2017,MALE,0,0,0,26,26,286.0
Shmuel,2017,MALE,0,0,0,72,72,190.0
Sholom,2017,MALE,0,0,0,17,17,376.0
Shraga,2017,MALE,0,0,0,11,11,502.0
Shulem,2017,MALE,0,0,0,36,36,253.0
Silas,2017,MALE,0,0,0,13,13,451.0
Simcha,2017,MALE,0,0,0,30,30,267.0
Simon,2017,MALE,0,0,0,39,39,242.0
Sincere,2017,MALE,0,18,0,0,18,363.0
Solomon,2017,MALE,0,20,0,100,120,147.0
Spencer,2017,MALE,22,0,0,38,60,204.0
Stephen,2017,MALE,0,24,22,0,46,230.0
Steven,2017,MALE,48,0,93,105,246,102.0
Syed,2017,MALE,23,0,0,0,23,304.0
Tahmid,2017,MALE,10,0,0,0,10,542.0
Tenzin,2017,MALE,29,0,0,0,29,271.0
Theo,2017,MALE,0,0,0,26,26,286.0
Theodore,2017,MALE,90,0,36,450,576,49.0
Thiago,2017,MALE,0,0,90,0,90,172.0
Thomas,2017,MALE,63,0,93,360,516,59.0
Timothy,2017,MALE,0,20,0,44,64,202.0
Tobias,2017,MALE,0,0,0,10,10,542.0
Tomas,2017,MALE,0,0,11,0,11,502.0
Travis,2017,MALE,12,0,0,0,12,473.0
Tristan,2017,MALE,48,140,80,52,320,85.0
Tyler,2017,MALE,116,136,112,148,512,60.0
Tzvi,2017,MALE,0,0,0,47,47,228.0
Uriel,2017,MALE,0,0,24,0,24,299.0
Usher,2017,MALE,0,0,0,22,22,313.0
Veer,2017,MALE,12,0,0,0,12,473.0
Victor,2017,MALE,42,0,105,69,216,110.0
Vincent,2017,MALE,66,0,57,153,276,94.0
Vincenzo,2017,MALE,0,0,0,11,11,502.0
Wesley,2017,MALE,22,0,0,54,76,184.0
William,2017,MALE,260,40,232,656,1188,23.0
Wyatt,2017,MALE,20,0,0,80,100,159.0
Xander,2017,MALE,0,0,36,22,58,210.0
Xavier,2017,MALE,40,148,220,48,456,67.0
Yaakov,2017,MALE,0,0,0,47,47,228.0
Yadiel,2017,MALE,0,0,15,0,15,412.0
Yahya,2017,MALE,22,0,0,22,44,233.0
Yakov,2017,MALE,0,0,0,72,72,190.0
Yariel,2017,MALE,0,0,10,0,10,542.0
Yaseen,2017,MALE,0,0,0,13,13,451.0
Yechiel,2017,MALE,0,0,0,23,23,304.0
Yehoshua,2017,MALE,0,0,0,25,25,295.0
Yehuda,2017,MALE,0,0,0,80,80,180.0
Yisrael,2017,MALE,0,0,0,21,21,325.0
Yisroel,2017,MALE,0,0,0,81,81,179.0
Yitzchok,2017,MALE,0,0,0,72,72,190.0
Yoel,2017,MALE,0,0,0,12,12,473.0
Yonatan,2017,MALE,0,0,0,11,11,502.0
Yosef,2017,MALE,0,0,0,106,106,156.0
Yossi,2017,MALE,0,0,0,12,12,473.0
Yousef,2017,MALE,0,0,0,22,22,313.0
Youssef,2017,MALE,0,0,0,15,15,412.0
Yusuf,2017,MALE,28,0,0,38,66,199.0
Zachary,2017,MALE,132,100,92,240,564,53.0
Zain,2017,MALE,0,0,0,15,15,412.0
Zaire,2017,MALE,0,24,0,0,24,299.0
Zakaria,2017,MALE,0,0,0,10,10,542.0
Zander,2017,MALE,0,0,10,0,10,542.0
Zane,2017,MALE,0,15,0,0,15,412.0
Zayan,2017,MALE,16,0,0,0,16,391.0
Zayden,2017,MALE,0,20,20,0,40,240.0
Zayn,2017,MALE,54,0,30,54,138,140.0
Zev,2017,MALE,0,0,0,55,55,216.0
Zion,2017,MALE,0,108,40,0,148,134.0
Aaliyah,2018,FEMALE,0,82,106,0,188,82.0
Aayat,2018,FEMALE,10,0,0,0,10,576.0
Abby,2018,FEMALE,12,0,0,0,12,488.0
Abigail,2018,FEMALE,108,140,436,416,1100,12.0
Ada,2018,FEMALE,0,0,0,17,17,375.0
Addison,2018,FEMALE,0,22,0,58,80,158.0
Adele,2018,FEMALE,0,0,0,31,31,267.0
Adelina,2018,FEMALE,0,0,0,12,12,488.0
Adeline,2018,FEMALE,0,0,34,48,82,154.0
Adelyn,2018,FEMALE,0,0,10,0,10,576.0
Adina,2018,FEMALE,0,0,0,25,25,292.0
Adriana,2018,FEMALE,0,0,58,38,96,134.0
Adrianna,2018,FEMALE,0,0,12,0,12,488.0
Ahuva,2018,FEMALE,0,0,0,20,20,334.0
Aileen,2018,FEMALE,0,0,18,0,18,360.0
Aisha,2018,FEMALE,63,84,0,63,210,75.0
Aissatou,2018,FEMALE,0,12,0,0,12,488.0
Aiza,2018,FEMALE,11,0,0,0,11,530.0
Alaia,2018,FEMALE,0,0,65,0,65,183.0
Alana,2018,FEMALE,0,0,28,0,28,276.0
Alani,2018,FEMALE,0,44,36,0,80,158.0
Alanna,2018,FEMALE,0,0,14,0,14,437.0
Alayna,2018,FEMALE,0,0,14,0,14,437.0
Aleah,2018,FEMALE,0,0,11,0,11,530.0
Aleena,2018,FEMALE,16,0,0,0,16,402.0
Alejandra,2018,FEMALE,0,0,20,0,20,334.0
Alessandra,2018,FEMALE,0,0,32,42,74,165.0
Alessia,2018,FEMALE,0,0,0,28,28,276.0
Alexa,2018,FEMALE,0,0,71,0,71,174.0
Alexandra,2018,FEMALE,30,0,75,186,291,62.0
Alexis,2018,FEMALE,0,0,0,10,10,576.0
Alia,2018,FEMALE,0,0,10,0,10,576.0
Aliah,2018,FEMALE,0,0,19,0,19,349.0
Alice,2018,FEMALE,93,0,75,204,372,48.0
Alicia,2018,FEMALE,0,0,20,0,20,334.0
Alina,2018,FEMALE,114,0,42,69,225,69.0
Alisa,2018,FEMALE,0,0,0,14,14,437.0
Alisha,2018,FEMALE,14,0,0,0,14,437.0
Alison,2018,FEMALE,0,0,22,0,22,308.0
Alisson,2018,FEMALE,0,0,10,0,10,576.0
Aliya,2018,FEMALE,10,0,0,0,10,576.0
Aliyah,2018,FEMALE,0,36,50,0,86,147.0
Aliza,2018,FEMALE,24,0,0,36,60,196.0
Allison,2018,FEMALE,42,0,207,48,297,61.0
Alma,2018,FEMALE,0,0,26,30,56,209.0
Alondra,2018,FEMALE,0,0,17,0,17,375.0
Alyssa,2018,FEMALE,60,42,87,0,189,80.0
Amaia,2018,FEMALE,0,0,36,0,36,251.0
Amalia,2018,FEMALE,0,0,58,36,94,136.0
Amanda,2018,FEMALE,0,0,22,0,22,308.0
Amaya,2018,FEMALE,48,66,168,0,282,63.0
Amayah,2018,FEMALE,0,12,0,0,12,488.0
Amber,2018,FEMALE,34,0,40,0,74,165.0
Amelia,2018,FEMALE,232,212,420,416,1280,9.0
Amina,2018,FEMALE,0,52,0,68,120,117.0
Aminata,2018,FEMALE,0,16,0,0,16,402.0
Amira,2018,FEMALE,40,48,48,88,224,70.0
Amirah,2018,FEMALE,0,16,0,0,16,402.0
Amiyah,2018,FEMALE,0,25,0,0,25,292.0
Amy,2018,FEMALE,40,0,112,0,152,98.0
Ana,2018,FEMALE,0,0,60,20,80,158.0
Anabia,2018,FEMALE,14,0,0,0,14,437.0
Anais,2018,FEMALE,0,0,13,0,13,468.0
Analia,2018,FEMALE,0,0,16,0,16,402.0
Anastasia,2018,FEMALE,0,0,24,34,58,203.0
Anaya,2018,FEMALE,72,33,36,0,141,103.0
Andrea,2018,FEMALE,0,0,32,0,32,262.0
Angela,2018,FEMALE,45,0,60,30,135,110.0
Angelica,2018,FEMALE,0,0,17,0,17,375.0
Angelina,2018,FEMALE,0,0,60,56,116,127.0
Angelique,2018,FEMALE,0,0,12,0,12,488.0
Anika,2018,FEMALE,11,0,0,0,11,530.0
Anisa,2018,FEMALE,0,0,0,10,10,576.0
Aniya,2018,FEMALE,0,14,0,0,14,437.0
Aniyah,2018,FEMALE,0,22,0,0,22,308.0
Anna,2018,FEMALE,78,0,45,246,369,50.0
Annabelle,2018,FEMALE,0,0,24,40,64,184.0
Annalise,2018,FEMALE,0,0,11,0,11,530.0
Annie,2018,FEMALE,25,0,0,0,25,292.0
Annika,2018,FEMALE,12,0,0,0,12,488.0
Antonella,2018,FEMALE,0,0,31,0,31,267.0
April,2018,FEMALE,0,0,17,0,17,375.0
Aria,2018,FEMALE,188,140,180,232,740,23.0
Ariadna,2018,FEMALE,0,0,12,0,12,488.0
Ariah,2018,FEMALE,0,62,22,0,84,151.0
Ariana,2018,FEMALE,80,64,312,164,620,28.0
Arianna,2018,FEMALE,0,39,105,51,195,78.0
Ariel,2018,FEMALE,32,32,0,0,64,184.0
Ariella,2018,FEMALE,0,0,28,76,104,131.0
Arielle,2018,FEMALE,0,57,30,54,141,103.0
Arisha,2018,FEMALE,10,0,0,0,10,576.0
Ariyah,2018,FEMALE,0,11,0,0,11,530.0
Arleth,2018,FEMALE,0,0,11,0,11,530.0
Arlette,2018,FEMALE,0,0,15,0,15,419.0
Arya,2018,FEMALE,156,72,88,44,360,52.0
Ashley,2018,FEMALE,57,0,213,36,306,58.0
Athena,2018,FEMALE,0,0,50,28,78,163.0
Aubree,2018,FEMALE,0,0,11,0,11,530.0
Aubrey,2018,FEMALE,0,51,99,33,183,85.0
Audrey,2018,FEMALE,52,0,0,72,124,114.0
Aurora,2018,FEMALE,30,0,78,63,171,89.0
Autumn,2018,FEMALE,0,52,26,0,78,163.0
Ava,2018,FEMALE,196,436,364,480,1476,6.0
Avery,2018,FEMALE,124,68,152,244,588,29.0
Avigail,2018,FEMALE,0,0,0,10,10,576.0
Aviva,2018,FEMALE,0,0,0,21,21,320.0
Aya,2018,FEMALE,0,0,0,15,15,419.0
Ayala,2018,FEMALE,0,0,0,12,12,488.0
Ayat,2018,FEMALE,17,0,0,0,17,375.0
Ayesha,2018,FEMALE,14,0,0,0,14,437.0
Ayla,2018,FEMALE,0,0,26,44,70,175.0
Aylin,2018,FEMALE,0,0,16,0,16,402.0
Azariah,2018,FEMALE,0,10,0,0,10,576.0
Baila,2018,FEMALE,0,0,0,66,66,182.0
Bailey,2018,FEMALE,0,10,0,0,10,576.0
Batsheva,2018,FEMALE,0,0,0,23,23,303.0
Beatrice,2018,FEMALE,0,0,0,27,27,282.0
Bella,2018,FEMALE,164,132,256,104,656,26.0
Bianca,2018,FEMALE,0,0,16,0,16,402.0
Billie,2018,FEMALE,0,0,0,11,11,530.0
Blake,2018,FEMALE,0,0,0,18,18,360.0
Blima,2018,FEMALE,0,0,0,28,28,276.0
Blimy,2018,FEMALE,0,0,0,35,35,254.0
Bracha,2018,FEMALE,0,0,0,20,20,334.0
Briana,2018,FEMALE,0,0,20,0,20,334.0
Brianna,2018,FEMALE,0,39,132,39,210,75.0
Briella,2018,FEMALE,0,0,14,0,14,437.0
Brielle,2018,FEMALE,0,111,33,60,204,77.0
Brittany,2018,FEMALE,0,0,12,0,12,488.0
Brooke,2018,FEMALE,0,26,0,54,80,158.0
Bruchy,2018,FEMALE,0,0,0,10,10,576.0
Cali,2018,FEMALE,0,13,0,0,13,468.0
Callie,2018,FEMALE,0,0,0,14,14,437.0
Camila,2018,FEMALE,0,0,354,26,380,46.0
Camilla,2018,FEMALE,0,0,0,21,21,320.0
Camille,2018,FEMALE,0,0,22,36,58,203.0
Caroline,2018,FEMALE,0,0,0,42,42,243.0
Cassidy,2018,FEMALE,0,11,0,0,11,530.0
Catalina,2018,FEMALE,0,0,32,0,32,262.0
Catherine,2018,FEMALE,28,0,0,56,84,151.0
Cecilia,2018,FEMALE,0,0,26,68,94,136.0
Celine,2018,FEMALE,54,0,33,84,171,89.0
Chana,2018,FEMALE,0,0,0,153,153,96.0
Chanel,2018,FEMALE,0,0,10,0,10,576.0
Chany,2018,FEMALE,0,0,0,40,40,248.0
Charlie,2018,FEMALE,0,0,0,15,15,419.0
Charlotte,2018,FEMALE,117,0,156,501,774,21.0
Chava,2018,FEMALE,0,0,0,34,34,256.0
Chavy,2018,FEMALE,0,0,0,18,18,360.0
Chaya,2018,FEMALE,0,0,0,189,189,80.0
Chelsea,2018,FEMALE,26,0,44,0,70,175.0
Chiara,2018,FEMALE,0,0,0,10,10,576.0
Chloe,2018,FEMALE,476,176,176,344,1172,10.0
Christina,2018,FEMALE,0,15,0,0,15,419.0
Claire,2018,FEMALE,60,0,0,78,138,106.0
Clara,2018,FEMALE,26,0,0,80,106,130.0
Colette,2018,FEMALE,0,0,0,25,25,292.0
Cora,2018,FEMALE,0,0,0,22,22,308.0
Cynthia,2018,FEMALE,11,0,0,0,11,530.0
Dahlia,2018,FEMALE,0,0,20,24,44,235.0
Daisy,2018,FEMALE,0,0,20,24,44,235.0
Daleyza,2018,FEMALE,0,0,13,0,13,468.0
Dalia,2018,FEMALE,0,0,0,11,11,530.0
Daniela,2018,FEMALE,0,0,50,0,50,216.0
Daniella,2018,FEMALE,0,0,36,24,60,196.0
Danna,2018,FEMALE,0,0,26,0,26,287.0
Daria,2018,FEMALE,0,0,0,11,11,530.0
Dayana,2018,FEMALE,0,0,13,0,13,468.0
Delilah,2018,FEMALE,0,0,35,0,35,254.0
Demi,2018,FEMALE,0,10,0,0,10,576.0
Destiny,2018,FEMALE,0,40,28,0,68,181.0
Devoiry,2018,FEMALE,0,0,0,12,12,488.0
Devora,2018,FEMALE,0,0,0,22,22,308.0
Devorah,2018,FEMALE,0,0,0,58,58,203.0
Diana,2018,FEMALE,0,0,56,38,94,136.0
Dina,2018,FEMALE,0,0,0,32,32,262.0
Diya,2018,FEMALE,11,0,0,0,11,530.0
Dream,2018,FEMALE,0,12,0,0,12,488.0
Dylan,2018,FEMALE,0,0,0,26,26,287.0
Eden,2018,FEMALE,0,0,0,18,18,360.0
Egypt,2018,FEMALE,0,18,0,0,18,360.0
Eileen,2018,FEMALE,24,0,26,0,50,216.0
Elaine,2018,FEMALE,10,0,0,0,10,576.0
Eleanor,2018,FEMALE,32,0,0,154,186,84.0
Elena,2018,FEMALE,66,0,105,78,249,66.0
Eliana,2018,FEMALE,52,76,156,252,536,34.0
Elianny,2018,FEMALE,0,0,10,0,10,576.0
Elina,2018,FEMALE,24,0,0,22,46,230.0
Elisa,2018,FEMALE,0,0,16,0,16,402.0
Elise,2018,FEMALE,0,22,0,36,58,203.0
Elisheva,2018,FEMALE,0,0,0,15,15,419.0
Eliza,2018,FEMALE,0,0,0,25,25,292.0
Elizabeth,2018,FEMALE,64,80,220,380,744,22.0
Ella,2018,FEMALE,108,0,87,378,573,31.0
Elle,2018,FEMALE,0,0,0,26,26,287.0
Elliana,2018,FEMALE,0,0,10,0,10,576.0
Ellie,2018,FEMALE,75,0,39,108,222,72.0
Eloise,2018,FEMALE,0,0,0,30,30,272.0
Emely,2018,FEMALE,0,0,25,0,25,292.0
Emerson,2018,FEMALE,0,0,0,16,16,402.0
Emilia,2018,FEMALE,60,0,144,231,435,43.0
Emily,2018,FEMALE,208,76,368,424,1076,13.0
Emma,2018,FEMALE,308,68,860,740,1976,1.0
Emmanuella,2018,FEMALE,0,13,0,0,13,468.0
Emmy,2018,FEMALE,0,0,22,22,44,235.0
Eshaal,2018,FEMALE,10,0,0,0,10,576.0
Esme,2018,FEMALE,0,0,0,18,18,360.0
Esmeralda,2018,FEMALE,0,0,17,0,17,375.0
Esther,2018,FEMALE,40,40,60,984,1124,11.0
Esty,2018,FEMALE,0,0,0,25,25,292.0
Etty,2018,FEMALE,0,0,0,14,14,437.0
Eva,2018,FEMALE,72,44,120,208,444,41.0
Eve,2018,FEMALE,0,0,0,22,22,308.0
Evelyn,2018,FEMALE,153,0,120,189,462,36.0
Everly,2018,FEMALE,0,0,30,20,50,216.0
Evie,2018,FEMALE,0,0,0,12,12,488.0
Faiga,2018,FEMALE,0,0,0,16,16,402.0
Faigy,2018,FEMALE,0,0,0,70,70,175.0
Faith,2018,FEMALE,0,60,34,0,94,136.0
Fanta,2018,FEMALE,0,12,0,0,12,488.0
Farah,2018,FEMALE,0,0,0,10,10,576.0
Fatima,2018,FEMALE,60,64,0,0,124,114.0
Fatoumata,2018,FEMALE,0,34,0,0,34,256.0
Fiona,2018,FEMALE,34,0,0,84,118,120.0
Florence,2018,FEMALE,0,0,0,12,12,488.0
Fradel,2018,FEMALE,0,0,0,11,11,530.0
Frady,2018,FEMALE,0,0,0,17,17,375.0
Fraidy,2018,FEMALE,0,0,0,19,19,349.0
Frances,2018,FEMALE,0,0,0,19,19,349.0
Francesca,2018,FEMALE,0,0,0,25,25,292.0
Freida,2018,FEMALE,0,0,0,11,11,530.0
Frida,2018,FEMALE,0,0,0,10,10,576.0
Frieda,2018,FEMALE,0,0,0,14,14,437.0
Frimet,2018,FEMALE,0,0,0,10,10,576.0
Gabriela,2018,FEMALE,0,0,30,0,30,272.0
Gabriella,2018,FEMALE,0,84,132,156,372,48.0
Gabrielle,2018,FEMALE,0,52,0,20,72,171.0
Gemma,2018,FEMALE,0,0,0,18,18,360.0
Genesis,2018,FEMALE,0,40,172,0,212,74.0
Genevieve,2018,FEMALE,0,0,0,17,17,375.0
Georgia,2018,FEMALE,0,0,0,28,28,276.0
Georgina,2018,FEMALE,0,0,0,11,11,530.0
Gia,2018,FEMALE,0,0,22,32,54,210.0
Gianna,2018,FEMALE,52,72,204,120,448,40.0
Giselle,2018,FEMALE,0,0,14,0,14,437.0
Gittel,2018,FEMALE,0,0,0,20,20,334.0
Gitty,2018,FEMALE,0,0,0,73,73,169.0
Giuliana,2018,FEMALE,0,0,0,19,19,349.0
Golda,2018,FEMALE,0,0,0,16,16,402.0
Goldie,2018,FEMALE,0,0,0,10,10,576.0
Goldy,2018,FEMALE,0,0,0,36,36,251.0
Grace,2018,FEMALE,200,92,212,364,868,15.0
Greta,2018,FEMALE,0,0,0,11,11,530.0
Hadassah,2018,FEMALE,0,0,0,15,15,419.0
Hafsa,2018,FEMALE,10,0,0,0,10,576.0
Hailey,2018,FEMALE,100,108,256,120,584,30.0
Hana,2018,FEMALE,0,0,0,11,11,530.0
Hanna,2018,FEMALE,32,0,0,30,62,192.0
Hannah,2018,FEMALE,148,68,136,344,696,24.0
Harley,2018,FEMALE,0,0,13,0,13,468.0
Harmony,2018,FEMALE,0,60,30,0,90,142.0
Harper,2018,FEMALE,60,0,0,112,172,87.0
Hawa,2018,FEMALE,0,17,0,0,17,375.0
Hazel,2018,FEMALE,0,0,22,42,64,184.0
Heaven,2018,FEMALE,0,38,26,0,64,184.0
Heavenly,2018,FEMALE,0,14,0,0,14,437.0
Helena,2018,FEMALE,0,0,0,10,10,576.0
Henny,2018,FEMALE,0,0,0,16,16,402.0
Hinda,2018,FEMALE,0,0,0,17,17,375.0
Hindy,2018,FEMALE,0,0,0,45,45,233.0
Hope,2018,FEMALE,0,13,0,0,13,468.0
Idy,2018,FEMALE,0,0,0,18,18,360.0
Imani,2018,FEMALE,0,16,0,0,16,402.0
Imona,2018,FEMALE,0,0,0,11,11,530.0
Inaaya,2018,FEMALE,31,0,0,0,31,267.0
Inaya,2018,FEMALE,18,0,0,0,18,360.0
Irene,2018,FEMALE,19,0,0,0,19,349.0
Iris,2018,FEMALE,42,0,0,32,74,165.0
Isabel,2018,FEMALE,33,0,81,99,213,73.0
Isabela,2018,FEMALE,0,0,11,0,11,530.0
Isabella,2018,FEMALE,200,172,1140,392,1904,2.0
Isabelle,2018,FEMALE,64,40,72,176,352,55.0
Isla,2018,FEMALE,20,0,0,72,92,140.0
Itzel,2018,FEMALE,0,0,14,0,14,437.0
Ivanna,2018,FEMALE,0,0,17,0,17,375.0
Ivy,2018,FEMALE,57,0,30,78,165,91.0
Jacqueline,2018,FEMALE,0,0,12,0,12,488.0
Jada,2018,FEMALE,0,17,0,0,17,375.0
Jade,2018,FEMALE,0,26,92,0,118,120.0
Jane,2018,FEMALE,0,0,0,21,21,320.0
Janiyah,2018,FEMALE,0,10,0,0,10,576.0
Jannat,2018,FEMALE,14,0,0,0,14,437.0
Jaslyn,2018,FEMALE,0,0,10,0,10,576.0
Jasmine,2018,FEMALE,48,0,57,33,138,106.0
Jayda,2018,FEMALE,0,12,0,0,12,488.0
Jayla,2018,FEMALE,0,38,46,0,84,151.0
Jaylah,2018,FEMALE,0,0,11,0,11,530.0
Jayleen,2018,FEMALE,0,0,26,0,26,287.0
Jaylene,2018,FEMALE,0,0,12,0,12,488.0
Jazlyn,2018,FEMALE,0,0,28,0,28,276.0
Jazmin,2018,FEMALE,0,0,11,0,11,530.0
Jenna,2018,FEMALE,0,0,0,10,10,576.0
Jennifer,2018,FEMALE,20,0,30,0,50,216.0
Jessica,2018,FEMALE,32,0,20,0,52,213.0
Jimena,2018,FEMALE,0,0,12,0,12,488.0
Joanna,2018,FEMALE,70,0,0,20,90,142.0
Jocelyn,2018,FEMALE,22,0,28,0,50,216.0
Jordyn,2018,FEMALE,0,13,0,0,13,468.0
Josephine,2018,FEMALE,32,0,0,88,120,117.0
Journee,2018,FEMALE,0,19,0,0,19,349.0
Journey,2018,FEMALE,0,10,0,0,10,576.0
Joy,2018,FEMALE,10,0,0,0,10,576.0
Judy,2018,FEMALE,0,0,0,10,10,576.0
Julia,2018,FEMALE,39,0,60,222,321,56.0
Juliana,2018,FEMALE,0,0,36,60,96,134.0
Julianna,2018,FEMALE,0,0,20,20,40,248.0
Julie,2018,FEMALE,0,0,10,0,10,576.0
Juliet,2018,FEMALE,0,0,38,52,90,142.0
Juliette,2018,FEMALE,0,0,80,92,172,87.0
Julissa,2018,FEMALE,0,0,13,0,13,468.0
June,2018,FEMALE,0,0,0,23,23,303.0
Juniper,2018,FEMALE,0,0,0,11,11,530.0
Kaia,2018,FEMALE,26,0,0,26,52,213.0
Kailani,2018,FEMALE,0,0,14,0,14,437.0
Kailey,2018,FEMALE,0,0,12,0,12,488.0
Kaitlyn,2018,FEMALE,28,0,34,0,62,192.0
Kali,2018,FEMALE,0,17,0,0,17,375.0
Kaliyah,2018,FEMALE,0,11,0,0,11,530.0
Kamila,2018,FEMALE,0,0,21,0,21,320.0
Karina,2018,FEMALE,11,0,0,0,11,530.0
Karla,2018,FEMALE,0,0,19,0,19,349.0
Kate,2018,FEMALE,0,0,0,12,12,488.0
Katherine,2018,FEMALE,42,0,90,120,252,65.0
Kayla,2018,FEMALE,68,92,100,104,364,51.0
Kaylani,2018,FEMALE,0,22,52,0,74,165.0
Kaylee,2018,FEMALE,54,54,195,0,303,59.0
Kaylie,2018,FEMALE,0,0,10,0,10,576.0
Kehlani,2018,FEMALE,0,26,38,0,64,184.0
Keily,2018,FEMALE,0,0,24,0,24,301.0
Keira,2018,FEMALE,0,0,0,17,17,375.0
Kelly,2018,FEMALE,24,0,20,0,44,235.0
Kelsey,2018,FEMALE,0,12,0,0,12,488.0
Kennedy,2018,FEMALE,0,28,0,20,48,223.0
Keyla,2018,FEMALE,0,0,15,0,15,419.0
Khadija,2018,FEMALE,0,13,0,0,13,468.0
Khadijah,2018,FEMALE,22,20,0,0,42,243.0
Khloe,2018,FEMALE,0,42,48,0,90,142.0
Kiara,2018,FEMALE,0,0,21,0,21,320.0
Kimberly,2018,FEMALE,0,0,47,0,47,227.0
Kimora,2018,FEMALE,0,11,0,0,11,530.0
Kira,2018,FEMALE,28,0,0,20,48,223.0
Kyla,2018,FEMALE,0,11,0,0,11,530.0
Kylie,2018,FEMALE,0,40,106,0,146,101.0
Laila,2018,FEMALE,0,44,0,38,82,154.0
Lana,2018,FEMALE,0,0,0,11,11,530.0
Lara,2018,FEMALE,0,0,0,12,12,488.0
Laura,2018,FEMALE,0,0,0,12,12,488.0
Lauren,2018,FEMALE,0,30,36,51,117,126.0
Layan,2018,FEMALE,0,0,0,16,16,402.0
Layla,2018,FEMALE,72,116,180,176,544,33.0
Lea,2018,FEMALE,0,0,0,21,21,320.0
Leah,2018,FEMALE,72,84,400,880,1436,7.0
Leela,2018,FEMALE,10,0,0,0,10,576.0
Leia,2018,FEMALE,0,0,28,20,48,223.0
Leila,2018,FEMALE,30,0,51,72,153,96.0
Leilani,2018,FEMALE,0,30,88,0,118,120.0
Lena,2018,FEMALE,0,0,0,21,21,320.0
Leora,2018,FEMALE,0,0,0,20,20,334.0
Leslie,2018,FEMALE,0,0,20,0,20,334.0
Leyla,2018,FEMALE,0,0,22,22,44,235.0
Lia,2018,FEMALE,0,0,68,54,122,116.0
Liana,2018,FEMALE,0,0,20,50,70,175.0
Lianna,2018,FEMALE,0,0,10,0,10,576.0
Liba,2018,FEMALE,0,0,0,20,20,334.0
Libby,2018,FEMALE,0,0,0,20,20,334.0
Lielle,2018,FEMALE,0,0,0,11,11,530.0
Lila,2018,FEMALE,0,0,0,45,45,233.0
Lilah,2018,FEMALE,0,0,0,16,16,402.0
Lilian,2018,FEMALE,0,0,0,10,10,576.0
Liliana,2018,FEMALE,0,0,32,40,72,171.0
Lillian,2018,FEMALE,30,0,36,96,162,92.0
Lily,2018,FEMALE,0,0,44,144,188,82.0
Lina,2018,FEMALE,0,0,0,15,15,419.0
Liv,2018,FEMALE,0,0,0,22,22,308.0
Livia,2018,FEMALE,0,0,0,10,10,576.0
Liyana,2018,FEMALE,10,0,0,0,10,576.0
Lizbeth,2018,FEMALE,0,0,15,0,15,419.0
Lola,2018,FEMALE,0,0,0,23,23,303.0
London,2018,FEMALE,0,42,28,0,70,175.0
Londyn,2018,FEMALE,0,17,0,0,17,375.0
Louisa,2018,FEMALE,0,0,0,21,21,320.0
Louise,2018,FEMALE,0,0,0,18,18,360.0
Lucia,2018,FEMALE,0,0,44,74,118,120.0
Luciana,2018,FEMALE,0,0,11,0,11,530.0
Lucy,2018,FEMALE,0,0,0,59,59,202.0
Luna,2018,FEMALE,87,0,459,117,663,25.0
Lydia,2018,FEMALE,28,0,0,32,60,196.0
Lyla,2018,FEMALE,0,0,0,22,22,308.0
Lyric,2018,FEMALE,0,14,0,0,14,437.0
Mabel,2018,FEMALE,0,0,0,14,14,437.0
Mackenzie,2018,FEMALE,0,33,39,75,147,99.0
Madeleine,2018,FEMALE,26,0,0,38,64,184.0
Madeline,2018,FEMALE,42,0,42,111,195,78.0
Madelyn,2018,FEMALE,0,0,34,46,80,158.0
Madison,2018,FEMALE,76,248,232,228,784,19.0
Madisyn,2018,FEMALE,0,10,0,0,10,576.0
Maeve,2018,FEMALE,0,0,0,13,13,468.0
Maia,2018,FEMALE,0,0,21,0,21,320.0
Makayla,2018,FEMALE,0,40,24,0,64,184.0
Malia,2018,FEMALE,0,42,20,0,62,192.0
Maliha,2018,FEMALE,10,0,0,0,10,576.0
Malika,2018,FEMALE,0,0,0,17,17,375.0
Maliyah,2018,FEMALE,0,13,0,0,13,468.0
Malka,2018,FEMALE,0,0,0,70,70,175.0
Malky,2018,FEMALE,0,0,0,61,61,195.0
Manha,2018,FEMALE,10,0,0,0,10,576.0
Margaret,2018,FEMALE,0,0,0,42,42,243.0
Margaux,2018,FEMALE,0,0,0,14,14,437.0
Margot,2018,FEMALE,0,0,0,34,34,256.0
Maria,2018,FEMALE,0,0,54,86,140,105.0
Mariah,2018,FEMALE,0,10,0,0,10,576.0
Mariam,2018,FEMALE,0,42,0,60,102,132.0
Mariama,2018,FEMALE,0,23,0,0,23,303.0
Mariana,2018,FEMALE,0,0,15,0,15,419.0
Marina,2018,FEMALE,0,0,0,13,13,468.0
Marley,2018,FEMALE,0,12,0,0,12,488.0
Mary,2018,FEMALE,0,0,0,20,20,334.0
Maryam,2018,FEMALE,50,0,0,42,92,140.0
Matilda,2018,FEMALE,0,0,0,21,21,320.0
Maya,2018,FEMALE,124,96,136,472,828,18.0
Mayar,2018,FEMALE,0,0,0,11,11,530.0
McKenzie,2018,FEMALE,0,10,0,0,10,576.0
Meghan,2018,FEMALE,0,0,11,0,11,530.0
Melanie,2018,FEMALE,0,30,180,33,243,68.0
Melany,2018,FEMALE,0,0,14,0,14,437.0
Melina,2018,FEMALE,0,0,22,28,50,216.0
Melissa,2018,FEMALE,0,0,46,26,72,171.0
Melody,2018,FEMALE,42,39,96,0,177,86.0
Mia,2018,FEMALE,332,140,788,552,1812,4.0
Micaela,2018,FEMALE,0,0,12,0,12,488.0
Michaela,2018,FEMALE,0,0,0,12,12,488.0
Michelle,2018,FEMALE,68,68,96,76,308,57.0
Mikaela,2018,FEMALE,0,0,0,12,12,488.0
Mila,2018,FEMALE,68,44,324,344,780,20.0
Milan,2018,FEMALE,0,10,0,0,10,576.0
Milana,2018,FEMALE,0,0,0,19,19,349.0
Milani,2018,FEMALE,0,12,0,0,12,488.0
Millie,2018,FEMALE,0,0,0,14,14,437.0
Mindy,2018,FEMALE,0,0,0,42,42,243.0
Mira,2018,FEMALE,0,0,0,18,18,360.0
Miracle,2018,FEMALE,0,20,0,0,20,334.0
Miranda,2018,FEMALE,0,0,11,0,11,530.0
Miri,2018,FEMALE,0,0,0,12,12,488.0
Miriam,2018,FEMALE,0,0,0,137,137,109.0
Miya,2018,FEMALE,14,0,0,0,14,437.0
Mollie,2018,FEMALE,0,0,0,10,10,576.0
Molly,2018,FEMALE,0,0,0,27,27,282.0
Montserrat,2018,FEMALE,0,0,12,0,12,488.0
Morgan,2018,FEMALE,0,24,0,30,54,210.0
Mushka,2018,FEMALE,0,0,0,11,11,530.0
Mya,2018,FEMALE,0,38,20,0,58,203.0
Myra,2018,FEMALE,13,0,0,0,13,468.0
Nailah,2018,FEMALE,0,12,0,0,12,488.0
Nala,2018,FEMALE,0,10,0,0,10,576.0
Naomi,2018,FEMALE,48,92,116,204,460,37.0
Nashla,2018,FEMALE,0,0,17,0,17,375.0
Natalia,2018,FEMALE,0,0,24,0,24,301.0
Natalie,2018,FEMALE,48,0,69,129,246,67.0
Nava,2018,FEMALE,0,0,0,15,15,419.0
Nayeli,2018,FEMALE,0,0,17,0,17,375.0
Nechama,2018,FEMALE,0,0,0,34,34,256.0
Nevaeh,2018,FEMALE,0,60,26,0,86,147.0
Nia,2018,FEMALE,0,19,0,0,19,349.0
Nicole,2018,FEMALE,45,0,87,129,261,64.0
Nina,2018,FEMALE,24,0,0,88,112,128.0
Noa,2018,FEMALE,0,0,0,42,42,243.0
Noelle,2018,FEMALE,0,0,0,15,15,419.0
Noor,2018,FEMALE,0,0,0,14,14,437.0
Nora,2018,FEMALE,32,0,0,128,160,93.0
Nova,2018,FEMALE,0,76,52,0,128,111.0
Nyla,2018,FEMALE,0,60,26,0,86,147.0
Nylah,2018,FEMALE,0,48,34,0,82,154.0
Olive,2018,FEMALE,0,0,0,18,18,360.0
Olivia,2018,FEMALE,436,240,336,792,1804,5.0
Olympia,2018,FEMALE,0,0,0,10,10,576.0
Orly,2018,FEMALE,0,0,0,10,10,576.0
Oumou,2018,FEMALE,0,17,0,0,17,375.0
Paige,2018,FEMALE,0,19,0,0,19,349.0
Paloma,2018,FEMALE,0,0,22,22,44,235.0
Paris,2018,FEMALE,0,23,0,0,23,303.0
Parizoda,2018,FEMALE,0,0,0,10,10,576.0
Parker,2018,FEMALE,0,0,0,18,18,360.0
Pearl,2018,FEMALE,0,0,0,36,36,251.0
Penelope,2018,FEMALE,63,0,174,201,438,42.0
Perel,2018,FEMALE,0,0,0,16,16,402.0
Perl,2018,FEMALE,0,0,0,18,18,360.0
Pessy,2018,FEMALE,0,0,0,31,31,267.0
Peyton,2018,FEMALE,0,34,26,0,60,196.0
Phoebe,2018,FEMALE,26,0,0,20,46,230.0
Phoenix,2018,FEMALE,0,24,20,0,44,235.0
Piper,2018,FEMALE,0,0,0,21,21,320.0
Poppy,2018,FEMALE,0,0,0,20,20,334.0
Princess,2018,FEMALE,0,12,0,0,12,488.0
Quinn,2018,FEMALE,0,0,0,40,40,248.0
Rachel,2018,FEMALE,30,0,0,346,376,47.0
Rahaf,2018,FEMALE,0,0,0,13,13,468.0
Raizel,2018,FEMALE,0,0,0,17,17,375.0
Raizy,2018,FEMALE,0,0,0,73,73,169.0
Raquel,2018,FEMALE,0,0,0,12,12,488.0
Reagan,2018,FEMALE,0,0,0,10,10,576.0
Rebecca,2018,FEMALE,0,0,20,66,86,147.0
Reem,2018,FEMALE,0,0,0,15,15,419.0
Reese,2018,FEMALE,0,0,0,17,17,375.0
Reign,2018,FEMALE,0,11,0,0,11,530.0
Reina,2018,FEMALE,11,0,0,0,11,530.0
Remi,2018,FEMALE,0,0,0,11,11,530.0
Remy,2018,FEMALE,0,0,0,17,17,375.0
Rifky,2018,FEMALE,0,0,0,14,14,437.0
Riley,2018,FEMALE,76,180,148,252,656,26.0
Rina,2018,FEMALE,0,0,0,12,12,488.0
Rivka,2018,FEMALE,0,0,0,128,128,111.0
Rivkah,2018,FEMALE,0,0,0,17,17,375.0
Rivky,2018,FEMALE,0,0,0,82,82,154.0
Rochel,2018,FEMALE,0,0,0,33,33,261.0
Romy,2018,FEMALE,0,0,0,11,11,530.0
Rose,2018,FEMALE,0,0,56,98,154,95.0
Rowan,2018,FEMALE,0,0,0,10,10,576.0
Royalty,2018,FEMALE,0,10,0,0,10,576.0
Ruby,2018,FEMALE,0,0,38,80,118,120.0
Ruchy,2018,FEMALE,0,0,0,22,22,308.0
Ruth,2018,FEMALE,0,0,0,22,22,308.0
Rylee,2018,FEMALE,0,11,0,0,11,530.0
Sabrina,2018,FEMALE,0,0,0,27,27,282.0
Sadie,2018,FEMALE,0,0,0,30,30,272.0
Safa,2018,FEMALE,12,0,0,0,12,488.0
Sage,2018,FEMALE,0,15,0,0,15,419.0
Samantha,2018,FEMALE,33,0,255,120,408,44.0
Samara,2018,FEMALE,26,0,94,0,120,117.0
Samira,2018,FEMALE,0,0,0,13,13,468.0
Sanai,2018,FEMALE,0,12,0,0,12,488.0
Saniyah,2018,FEMALE,0,15,0,0,15,419.0
Sara,2018,FEMALE,39,0,90,363,492,35.0
Sarah,2018,FEMALE,140,112,204,856,1312,8.0
Sarai,2018,FEMALE,0,46,42,0,88,146.0
Sariyah,2018,FEMALE,0,10,0,0,10,576.0
Sasha,2018,FEMALE,0,0,0,17,17,375.0
Savannah,2018,FEMALE,0,117,168,102,387,45.0
Scarlett,2018,FEMALE,54,0,249,153,456,38.0
Selena,2018,FEMALE,0,0,21,0,21,320.0
Selina,2018,FEMALE,10,0,0,0,10,576.0
Serena,2018,FEMALE,36,0,0,28,64,184.0
Serenity,2018,FEMALE,0,66,46,0,112,128.0
Shaina,2018,FEMALE,0,0,0,14,14,437.0
Shaindel,2018,FEMALE,0,0,0,17,17,375.0
Shaindy,2018,FEMALE,0,0,0,57,57,208.0
Sherlyn,2018,FEMALE,0,0,11,0,11,530.0
Shevy,2018,FEMALE,0,0,0,11,11,530.0
Shifra,2018,FEMALE,0,0,0,19,19,349.0
Shira,2018,FEMALE,0,0,0,16,16,402.0
Shoshana,2018,FEMALE,0,0,0,18,18,360.0
Shukrona,2018,FEMALE,0,0,0,15,15,419.0
Siena,2018,FEMALE,0,0,0,17,17,375.0
Sienna,2018,FEMALE,0,0,34,122,156,94.0
Sima,2018,FEMALE,0,0,0,22,22,308.0
Simi,2018,FEMALE,0,0,0,13,13,468.0
Simone,2018,FEMALE,0,20,0,40,60,196.0
Skyla,2018,FEMALE,0,14,0,0,14,437.0
Skylah,2018,FEMALE,0,11,0,0,11,530.0
Skylar,2018,FEMALE,52,224,92,88,456,38.0
Sloane,2018,FEMALE,0,0,0,34,34,256.0
Sofia,2018,FEMALE,72,0,465,321,858,17.0
Sophia,2018,FEMALE,320,80,848,576,1824,3.0
Sophie,2018,FEMALE,78,0,30,192,300,60.0
Stacy,2018,FEMALE,0,0,11,0,11,530.0
Stella,2018,FEMALE,81,0,54,222,357,53.0
Stephanie,2018,FEMALE,36,0,57,33,126,113.0
Summer,2018,FEMALE,40,68,56,60,224,70.0
Suri,2018,FEMALE,0,0,0,13,13,468.0
Sury,2018,FEMALE,0,0,0,47,47,227.0
Sydney,2018,FEMALE,0,0,0,26,26,287.0
Syeda,2018,FEMALE,14,0,0,0,14,437.0
Sylvia,2018,FEMALE,22,0,0,26,48,223.0
Sylvie,2018,FEMALE,0,0,0,10,10,576.0
Talia,2018,FEMALE,0,0,0,50,50,216.0
Tallulah,2018,FEMALE,0,0,0,11,11,530.0
Tamar,2018,FEMALE,0,0,0,13,13,468.0
Taylor,2018,FEMALE,0,72,33,42,147,99.0
Teagan,2018,FEMALE,0,0,0,12,12,488.0
Tehila,2018,FEMALE,0,0,0,15,15,419.0
Tenzin,2018,FEMALE,27,0,0,0,27,282.0
Tessa,2018,FEMALE,0,0,0,21,21,320.0
Thea,2018,FEMALE,0,0,0,12,12,488.0
Theodora,2018,FEMALE,0,0,0,14,14,437.0
Tiffany,2018,FEMALE,14,0,0,0,14,437.0
Tina,2018,FEMALE,10,0,0,0,10,576.0
Toby,2018,FEMALE,0,0,0,32,32,262.0
Tori,2018,FEMALE,0,12,0,0,12,488.0
Trany,2018,FEMALE,0,0,0,14,14,437.0
Trinity,2018,FEMALE,0,16,0,0,16,402.0
Tzipora,2018,FEMALE,0,0,0,13,13,468.0
Valentina,2018,FEMALE,0,0,264,90,354,54.0
Valeria,2018,FEMALE,0,0,46,0,46,230.0
Valerie,2018,FEMALE,0,0,94,24,118,120.0
Valery,2018,FEMALE,0,0,11,0,11,530.0
Vanessa,2018,FEMALE,0,0,40,20,60,196.0
Vera,2018,FEMALE,0,0,0,28,28,276.0
Veronica,2018,FEMALE,0,0,0,21,21,320.0
Victoria,2018,FEMALE,96,92,400,300,888,14.0
Violet,2018,FEMALE,0,0,44,100,144,102.0
Vivian,2018,FEMALE,40,0,0,58,98,133.0
Viviana,2018,FEMALE,0,0,0,10,10,576.0
Vivienne,2018,FEMALE,0,0,0,30,30,272.0
Willa,2018,FEMALE,0,0,0,20,20,334.0
Wynter,2018,FEMALE,0,12,0,0,12,488.0
Ximena,2018,FEMALE,0,0,31,0,31,267.0
Yael,2018,FEMALE,0,0,0,14,14,437.0
Yara,2018,FEMALE,0,24,0,28,52,213.0
Yaretzi,2018,FEMALE,0,0,22,0,22,308.0
Yehudis,2018,FEMALE,0,0,0,20,20,334.0
Yides,2018,FEMALE,0,0,0,27,27,282.0
Yitty,2018,FEMALE,0,0,0,44,44,235.0
Yocheved,2018,FEMALE,0,0,0,25,25,292.0
Zahra,2018,FEMALE,34,20,0,0,54,210.0
Zainab,2018,FEMALE,17,0,0,0,17,375.0
Zara,2018,FEMALE,69,0,33,36,138,106.0
Zaria,2018,FEMALE,0,11,0,0,11,530.0
Zelda,2018,FEMALE,0,0,0,12,12,488.0
Zissy,2018,FEMALE,0,0,0,32,32,262.0
Zoe,2018,FEMALE,132,120,296,320,868,15.0
Zoey,2018,FEMALE,88,168,180,116,552,32.0
Zoya,2018,FEMALE,15,0,0,0,15,419.0
Zuri,2018,FEMALE,0,47,0,0,47,227.0
Aahil,2018,MALE,10,0,0,0,10,539.0
Aarav,2018,MALE,17,0,0,0,17,375.0
Aaron,2018,MALE,232,108,572,304,1216,22.0
Aayan,2018,MALE,11,0,0,0,11,503.0
Abdiel,2018,MALE,0,0,25,0,25,304.0
Abdoulaye,2018,MALE,0,15,0,0,15,405.0
Abdul,2018,MALE,15,0,0,0,15,405.0
Abdullah,2018,MALE,50,0,0,20,70,192.0
Abdulloh,2018,MALE,0,0,0,13,13,455.0
Abel,2018,MALE,0,0,27,0,27,293.0
Abraham,2018,MALE,0,0,46,252,298,88.0
Abrar,2018,MALE,18,0,0,0,18,363.0
Ace,2018,MALE,0,14,0,0,14,427.0
Adam,2018,MALE,141,0,99,459,699,40.0
Adonis,2018,MALE,0,62,52,0,114,154.0
Adrian,2018,MALE,88,56,476,152,772,35.0
Adriel,2018,MALE,0,0,38,0,38,260.0
Aharon,2018,MALE,0,0,0,12,12,475.0
Ahmad,2018,MALE,26,0,0,20,46,240.0
Ahmed,2018,MALE,42,36,0,123,201,108.0
Ahron,2018,MALE,0,0,0,19,19,350.0
Aidan,2018,MALE,28,0,0,72,100,166.0
Aiden,2018,MALE,472,472,612,332,1888,5.0
Akiva,2018,MALE,0,0,0,25,25,304.0
Alan,2018,MALE,63,0,135,48,246,100.0
Albert,2018,MALE,0,0,28,38,66,198.0
Alejandro,2018,MALE,0,0,53,0,53,232.0
Alessandro,2018,MALE,0,0,10,0,10,539.0
Alex,2018,MALE,104,44,136,96,380,72.0
Alexander,2018,MALE,156,100,604,780,1640,10.0
Alexis,2018,MALE,0,0,19,0,19,350.0
Alfredo,2018,MALE,0,0,10,0,10,539.0
Ali,2018,MALE,60,45,0,108,213,106.0
Allan,2018,MALE,0,0,19,0,19,350.0
Allen,2018,MALE,46,0,30,0,76,183.0
Alvin,2018,MALE,34,0,20,0,54,228.0
Amari,2018,MALE,0,84,22,0,106,162.0
Amir,2018,MALE,0,252,72,93,417,67.0
Amirjon,2018,MALE,0,0,0,10,10,539.0
Anderson,2018,MALE,0,0,15,0,15,405.0
Andre,2018,MALE,0,20,20,0,40,256.0
Andres,2018,MALE,0,0,25,0,25,304.0
Andrew,2018,MALE,144,68,240,304,756,37.0
Andy,2018,MALE,36,0,30,0,66,198.0
Angel,2018,MALE,0,0,126,0,126,148.0
Angelo,2018,MALE,0,0,26,26,52,234.0
Ansel,2018,MALE,0,0,0,11,11,503.0
Anson,2018,MALE,13,0,0,0,13,455.0
Anthony,2018,MALE,72,136,412,360,980,29.0
Antonio,2018,MALE,0,0,38,34,72,189.0
Archer,2018,MALE,0,0,0,13,13,455.0
Arham,2018,MALE,30,0,0,0,30,276.0
Ari,2018,MALE,0,0,0,69,69,194.0
Ariel,2018,MALE,0,0,34,44,78,180.0
Arjun,2018,MALE,14,0,0,0,14,427.0
Arlo,2018,MALE,0,0,0,21,21,328.0
Armani,2018,MALE,0,0,12,0,12,475.0
Aron,2018,MALE,0,0,0,64,64,205.0
Arthur,2018,MALE,0,0,0,43,43,249.0
Arturo,2018,MALE,0,0,10,0,10,539.0
Aryan,2018,MALE,26,0,0,0,26,296.0
Arye,2018,MALE,0,0,0,10,10,539.0
Aryeh,2018,MALE,0,0,0,24,24,309.0
Asher,2018,MALE,44,100,156,360,660,42.0
Ashton,2018,MALE,39,96,63,0,198,111.0
August,2018,MALE,0,26,0,66,92,170.0
Austin,2018,MALE,140,88,224,128,580,50.0
Avery,2018,MALE,0,69,63,39,171,123.0
Avi,2018,MALE,0,0,0,13,13,455.0
Avraham,2018,MALE,0,0,0,56,56,221.0
Avrohom,2018,MALE,0,0,0,23,23,314.0
Avrum,2018,MALE,0,0,0,17,17,375.0
Axel,2018,MALE,0,0,146,50,196,113.0
Ayaan,2018,MALE,45,0,0,0,45,245.0
Ayan,2018,MALE,12,0,0,0,12,475.0
Ayden,2018,MALE,45,105,246,0,396,69.0
Baruch,2018,MALE,0,0,0,19,19,350.0
Ben,2018,MALE,0,0,0,17,17,375.0
Benjamin,2018,MALE,128,76,244,800,1248,20.0
Bennett,2018,MALE,0,0,0,22,22,323.0
Benzion,2018,MALE,0,0,0,19,19,350.0
Berish,2018,MALE,0,0,0,12,12,475.0
Berl,2018,MALE,0,0,0,11,11,503.0
Binyamin,2018,MALE,0,0,0,11,11,503.0
Binyomin,2018,MALE,0,0,0,12,12,475.0
Blake,2018,MALE,0,0,0,13,13,455.0
Bodhi,2018,MALE,0,0,0,10,10,539.0
Boruch,2018,MALE,0,0,0,13,13,455.0
Brady,2018,MALE,0,0,0,12,12,475.0
Brandon,2018,MALE,108,76,264,92,540,56.0
Brayden,2018,MALE,36,0,78,48,162,128.0
Brendan,2018,MALE,20,0,0,20,40,256.0
Brian,2018,MALE,96,0,42,36,174,120.0
Brody,2018,MALE,0,0,0,23,23,314.0
Bryan,2018,MALE,45,39,117,0,201,108.0
Bryce,2018,MALE,0,70,28,0,98,167.0
Bryson,2018,MALE,0,72,46,0,118,153.0
Burech,2018,MALE,0,0,0,11,11,503.0
Caiden,2018,MALE,0,38,22,0,60,213.0
Cairo,2018,MALE,0,20,0,0,20,340.0
Caleb,2018,MALE,60,176,176,136,548,55.0
Calvin,2018,MALE,20,0,0,38,58,218.0
Cameron,2018,MALE,40,116,68,140,364,76.0
Carlos,2018,MALE,0,0,64,0,64,205.0
Carmine,2018,MALE,0,0,0,12,12,475.0
Carter,2018,MALE,64,252,132,104,552,53.0
Cayden,2018,MALE,0,36,20,0,56,221.0
Cesar,2018,MALE,0,0,17,0,17,375.0
Chaim,2018,MALE,0,0,0,134,134,141.0
Chance,2018,MALE,0,22,0,0,22,323.0
Charles,2018,MALE,60,0,42,351,453,61.0
Charlie,2018,MALE,0,0,26,52,78,180.0
Chase,2018,MALE,40,176,80,76,372,75.0
Cheskel,2018,MALE,0,0,0,18,18,363.0
Chesky,2018,MALE,0,0,0,11,11,503.0
Chris,2018,MALE,0,0,12,0,12,475.0
Christian,2018,MALE,52,172,256,156,636,46.0
Christopher,2018,MALE,84,112,400,220,816,34.0
Cody,2018,MALE,0,0,0,10,10,539.0
Cole,2018,MALE,0,0,0,32,32,269.0
Colin,2018,MALE,26,0,0,38,64,205.0
Colton,2018,MALE,0,0,0,10,10,539.0
Connor,2018,MALE,75,0,30,150,255,96.0
Conor,2018,MALE,0,0,0,14,14,427.0
Cooper,2018,MALE,0,0,0,27,27,293.0
Cristian,2018,MALE,0,0,29,0,29,281.0
Cristopher,2018,MALE,0,0,10,0,10,539.0
Cyrus,2018,MALE,22,0,0,20,42,252.0
Dallas,2018,MALE,0,11,0,0,11,503.0
Damian,2018,MALE,0,0,53,0,53,232.0
Damien,2018,MALE,0,0,15,0,15,405.0
Daniel,2018,MALE,272,184,532,668,1656,9.0
Danny,2018,MALE,0,0,16,0,16,391.0
Dante,2018,MALE,0,0,20,0,20,340.0
Dariel,2018,MALE,0,0,20,0,20,340.0
Darius,2018,MALE,0,10,0,0,10,539.0
Darren,2018,MALE,15,0,0,0,15,405.0
David,2018,MALE,76,148,516,1096,1836,6.0
Dean,2018,MALE,0,0,0,34,34,265.0
Declan,2018,MALE,0,0,0,22,22,323.0
Derek,2018,MALE,24,0,44,0,68,195.0
Desmond,2018,MALE,0,0,0,13,13,455.0
Devin,2018,MALE,10,0,0,0,10,539.0
Diego,2018,MALE,0,0,57,0,57,220.0
Dominic,2018,MALE,0,36,84,75,195,114.0
Dominick,2018,MALE,0,0,20,26,46,240.0
Dov,2018,MALE,0,0,0,36,36,262.0
Dovid,2018,MALE,0,0,0,33,33,268.0
Duvid,2018,MALE,0,0,0,17,17,375.0
Dylan,2018,MALE,148,124,976,392,1640,10.0
Ean,2018,MALE,0,0,30,0,30,276.0
Eason,2018,MALE,20,0,0,0,20,340.0
Eden,2018,MALE,12,0,0,0,12,475.0
Edgar,2018,MALE,0,0,12,0,12,475.0
Edison,2018,MALE,10,0,0,0,10,539.0
Eduardo,2018,MALE,0,0,14,0,14,427.0
Edward,2018,MALE,48,0,66,120,234,103.0
Edwin,2018,MALE,0,0,22,0,22,323.0
Efraim,2018,MALE,0,0,0,19,19,350.0
Eitan,2018,MALE,0,0,0,15,15,405.0
Eli,2018,MALE,48,72,96,420,636,46.0
Elian,2018,MALE,0,0,31,0,31,273.0
Elias,2018,MALE,52,72,460,184,768,36.0
Eliezer,2018,MALE,0,0,0,41,41,255.0
Elijah,2018,MALE,72,316,396,96,880,31.0
Elimelech,2018,MALE,0,0,0,14,14,427.0
Eliyahu,2018,MALE,0,0,0,29,29,281.0
Elliot,2018,MALE,0,0,20,84,104,163.0
Elliott,2018,MALE,0,0,0,12,12,475.0
Ellis,2018,MALE,0,0,0,15,15,405.0
Elvis,2018,MALE,17,0,0,0,17,375.0
Elya,2018,MALE,0,0,0,15,15,405.0
Emanuel,2018,MALE,0,0,17,0,17,375.0
Emiliano,2018,MALE,0,0,15,0,15,405.0
Emilio,2018,MALE,0,0,26,0,26,296.0
Emir,2018,MALE,0,0,0,11,11,503.0
Emmanuel,2018,MALE,0,56,108,0,164,126.0
Emmett,2018,MALE,0,0,0,14,14,427.0
Enzo,2018,MALE,0,0,24,0,24,309.0
Eric,2018,MALE,195,0,48,36,279,92.0
Erick,2018,MALE,0,0,56,0,56,221.0
Esteban,2018,MALE,0,0,11,0,11,503.0
Ethan,2018,MALE,580,336,860,428,2204,3.0
Evan,2018,MALE,153,0,117,162,432,64.0
Everett,2018,MALE,0,0,0,14,14,427.0
Ezekiel,2018,MALE,0,30,36,0,66,198.0
Ezequiel,2018,MALE,0,0,14,0,14,427.0
Ezra,2018,MALE,0,36,84,195,315,85.0
Fabian,2018,MALE,0,0,10,0,10,539.0
Felix,2018,MALE,24,0,0,84,108,158.0
Finn,2018,MALE,0,0,0,46,46,240.0
Finnegan,2018,MALE,0,0,0,10,10,539.0
Fishel,2018,MALE,0,0,0,15,15,405.0
Francesco,2018,MALE,0,0,0,12,12,475.0
Francis,2018,MALE,0,0,0,17,17,375.0
Francisco,2018,MALE,0,0,28,0,28,287.0
Frank,2018,MALE,0,0,0,10,10,539.0
Frederick,2018,MALE,0,0,0,18,18,363.0
Gabriel,2018,MALE,60,132,380,508,1080,26.0
Gael,2018,MALE,0,0,110,0,110,157.0
Gavin,2018,MALE,32,0,0,60,92,170.0
Gavriel,2018,MALE,0,0,0,10,10,539.0
George,2018,MALE,42,0,54,222,318,82.0
Giovanni,2018,MALE,0,54,84,87,225,104.0
Giuseppe,2018,MALE,0,0,0,12,12,475.0
Graham,2018,MALE,0,0,0,21,21,328.0
Grant,2018,MALE,0,0,0,14,14,427.0
Grayson,2018,MALE,60,64,132,136,392,70.0
Gregory,2018,MALE,0,0,0,15,15,405.0
Greyson,2018,MALE,0,54,75,42,171,123.0
Griffin,2018,MALE,0,0,0,14,14,427.0
Hamza,2018,MALE,20,0,0,40,60,213.0
Harrison,2018,MALE,32,0,0,60,92,170.0
Harry,2018,MALE,0,0,0,21,21,328.0
Hassan,2018,MALE,0,0,0,10,10,539.0
Hayden,2018,MALE,28,0,0,26,54,228.0
Hector,2018,MALE,0,0,26,0,26,296.0
Henry,2018,MALE,117,0,126,486,729,39.0
Hershel,2018,MALE,0,0,0,11,11,503.0
Hershy,2018,MALE,0,0,0,30,30,276.0
Hillel,2018,MALE,0,0,0,13,13,455.0
Holden,2018,MALE,0,0,0,13,13,455.0
Hudson,2018,MALE,32,0,0,140,172,122.0
Hugo,2018,MALE,0,0,0,20,20,340.0
Hunter,2018,MALE,64,200,128,164,556,52.0
Ian,2018,MALE,135,0,321,69,525,57.0
Ibrahim,2018,MALE,87,90,0,60,237,102.0
Ibrahima,2018,MALE,0,13,0,0,13,455.0
Iker,2018,MALE,0,0,24,0,24,309.0
Ilan,2018,MALE,0,0,0,11,11,503.0
Imran,2018,MALE,0,0,0,17,17,375.0
Isaac,2018,MALE,84,80,380,548,1092,25.0
Isaiah,2018,MALE,0,84,90,0,174,120.0
Isaias,2018,MALE,0,0,17,0,17,375.0
Ishaan,2018,MALE,12,0,0,0,12,475.0
Ismael,2018,MALE,0,0,26,0,26,296.0
Ismail,2018,MALE,11,0,0,0,11,503.0
Israel,2018,MALE,0,30,54,84,168,125.0
Ivaan,2018,MALE,10,0,0,0,10,539.0
Ivan,2018,MALE,81,0,87,33,201,108.0
Jace,2018,MALE,0,117,135,30,282,91.0
Jack,2018,MALE,81,0,57,537,675,41.0
Jackson,2018,MALE,48,0,51,222,321,81.0
Jacob,2018,MALE,184,144,964,868,2160,4.0
Jad,2018,MALE,0,0,0,11,11,503.0
Jaden,2018,MALE,51,63,81,0,195,114.0
Jadiel,2018,MALE,0,0,24,0,24,309.0
Jael,2018,MALE,0,0,16,0,16,391.0
Jaiden,2018,MALE,0,38,24,0,62,210.0
Jake,2018,MALE,0,0,54,74,128,147.0
Jamari,2018,MALE,0,14,0,0,14,427.0
James,2018,MALE,152,92,280,768,1292,19.0
Jameson,2018,MALE,0,0,0,11,11,503.0
Jamir,2018,MALE,0,12,0,0,12,475.0
Jared,2018,MALE,0,0,13,0,13,455.0
Jariel,2018,MALE,0,0,11,0,11,503.0
Jasiah,2018,MALE,0,12,0,0,12,475.0
Jason,2018,MALE,252,120,152,128,652,44.0
Jasper,2018,MALE,270,0,0,48,318,82.0
Javier,2018,MALE,0,0,37,0,37,261.0
Jax,2018,MALE,0,0,24,20,44,246.0
Jaxon,2018,MALE,0,69,81,48,198,111.0
Jaxson,2018,MALE,0,45,54,36,135,140.0
Jay,2018,MALE,0,0,15,0,15,405.0
Jayce,2018,MALE,0,72,88,0,160,129.0
Jayceon,2018,MALE,0,18,0,0,18,363.0
Jayden,2018,MALE,352,312,864,72,1600,12.0
Jaylen,2018,MALE,0,20,0,0,20,340.0
Jayson,2018,MALE,0,0,15,0,15,405.0
Jean,2018,MALE,0,0,12,0,12,475.0
Jefferson,2018,MALE,0,0,16,0,16,391.0
Jeffrey,2018,MALE,34,0,24,0,58,218.0
Jeremiah,2018,MALE,0,198,138,0,336,80.0
Jeremias,2018,MALE,0,0,11,0,11,503.0
Jeremy,2018,MALE,36,0,154,0,190,117.0
Jerry,2018,MALE,10,0,0,0,10,539.0
Jesus,2018,MALE,0,0,48,0,48,237.0
Joaquin,2018,MALE,0,0,14,0,14,427.0
Joel,2018,MALE,0,42,129,87,258,95.0
Johan,2018,MALE,0,0,26,0,26,296.0
John,2018,MALE,80,52,224,628,984,28.0
Jonah,2018,MALE,0,0,54,84,138,137.0
Jonas,2018,MALE,0,0,21,0,21,328.0
Jonathan,2018,MALE,120,80,272,188,660,42.0
Jordan,2018,MALE,72,128,104,128,432,64.0
Jorge,2018,MALE,0,0,20,0,20,340.0
Jose,2018,MALE,0,0,67,0,67,197.0
Joseph,2018,MALE,60,84,368,992,1504,14.0
Joshua,2018,MALE,136,288,400,276,1100,24.0
Josiah,2018,MALE,0,182,166,0,348,78.0
Josue,2018,MALE,0,0,47,0,47,238.0
Joziah,2018,MALE,0,0,11,0,11,503.0
Juan,2018,MALE,0,0,43,0,43,249.0
Judah,2018,MALE,0,20,0,54,74,187.0
Jude,2018,MALE,0,0,0,29,29,281.0
Julian,2018,MALE,80,72,364,356,872,33.0
Julio,2018,MALE,0,0,14,0,14,427.0
Julius,2018,MALE,0,33,69,42,144,135.0
Justice,2018,MALE,0,22,20,0,42,252.0
Justin,2018,MALE,192,112,300,48,652,44.0
Kabir,2018,MALE,13,0,0,0,13,455.0
Kai,2018,MALE,68,116,76,84,344,79.0
Kaiden,2018,MALE,0,88,50,0,138,137.0
Kairo,2018,MALE,0,36,0,0,36,262.0
Kaleb,2018,MALE,0,22,38,0,60,213.0
Kamari,2018,MALE,0,13,0,0,13,455.0
Kameron,2018,MALE,0,19,0,0,19,350.0
Kareem,2018,MALE,0,11,0,0,11,503.0
Karter,2018,MALE,0,29,0,0,29,281.0
Kayden,2018,MALE,63,156,216,0,435,63.0
Kendrick,2018,MALE,0,0,10,0,10,539.0
Kenneth,2018,MALE,24,0,38,0,62,210.0
Kenzo,2018,MALE,0,20,0,0,20,340.0
Kevin,2018,MALE,152,76,236,88,552,53.0
Khalil,2018,MALE,0,17,0,0,17,375.0
Khari,2018,MALE,0,11,0,0,11,503.0
Kian,2018,MALE,0,0,0,11,11,503.0
Kieran,2018,MALE,0,0,0,16,16,391.0
King,2018,MALE,0,104,60,0,164,126.0
Kingsley,2018,MALE,14,0,0,0,14,427.0
Kingston,2018,MALE,0,11,0,0,11,503.0
Kyle,2018,MALE,156,56,56,48,316,84.0
Kyrie,2018,MALE,0,110,36,0,146,134.0
Laith,2018,MALE,0,0,0,11,11,503.0
Landon,2018,MALE,0,0,42,20,62,210.0
Lazer,2018,MALE,0,0,0,17,17,375.0
Leandro,2018,MALE,0,0,19,0,19,350.0
Legend,2018,MALE,0,20,0,0,20,340.0
Lennox,2018,MALE,0,0,10,0,10,539.0
Leo,2018,MALE,172,64,160,656,1052,27.0
Leon,2018,MALE,72,0,48,135,255,96.0
Leonard,2018,MALE,0,0,0,15,15,405.0
Leonardo,2018,MALE,0,0,116,78,194,116.0
Leonel,2018,MALE,0,0,11,0,11,503.0
Lev,2018,MALE,0,0,0,28,28,287.0
Levi,2018,MALE,0,75,63,147,285,90.0
Liam,2018,MALE,336,496,1596,620,3048,1.0
Lincoln,2018,MALE,0,0,20,32,52,234.0
Lipa,2018,MALE,0,0,0,26,26,296.0
Logan,2018,MALE,172,364,432,352,1320,18.0
Lorenzo,2018,MALE,0,0,62,50,112,156.0
Louis,2018,MALE,38,0,0,50,88,175.0
Luca,2018,MALE,54,0,81,312,447,62.0
Lucas,2018,MALE,436,72,820,456,1784,7.0
Luis,2018,MALE,0,0,65,0,65,204.0
Luka,2018,MALE,0,0,0,25,25,304.0
Lukas,2018,MALE,0,0,44,34,78,180.0
Luke,2018,MALE,84,56,44,312,496,59.0
Maddox,2018,MALE,0,0,10,0,10,539.0
Mahamadou,2018,MALE,0,10,0,0,10,539.0
Maison,2018,MALE,0,0,15,0,15,405.0
Major,2018,MALE,0,14,0,0,14,427.0
Malachi,2018,MALE,0,42,0,0,42,252.0
Malek,2018,MALE,0,0,0,10,10,539.0
Malik,2018,MALE,0,36,0,20,56,221.0
Mamadou,2018,MALE,0,28,0,0,28,287.0
Manuel,2018,MALE,0,0,17,0,17,375.0
Marc,2018,MALE,0,0,0,18,18,363.0
Marcel,2018,MALE,0,0,0,12,12,475.0
Marcelo,2018,MALE,0,0,14,0,14,427.0
Marco,2018,MALE,0,0,30,40,70,192.0
Marcos,2018,MALE,0,0,15,0,15,405.0
Marcus,2018,MALE,100,60,76,52,288,89.0
Mario,2018,MALE,0,0,14,0,14,427.0
Mark,2018,MALE,0,22,0,108,130,145.0
Martin,2018,MALE,0,0,42,66,108,158.0
Mason,2018,MALE,188,296,540,332,1356,16.0
Mateo,2018,MALE,0,0,224,38,262,94.0
Mathew,2018,MALE,0,0,13,0,13,455.0
Mathias,2018,MALE,0,0,29,0,29,281.0
Matias,2018,MALE,0,0,79,0,79,179.0
Matteo,2018,MALE,0,0,92,52,144,135.0
Matthew,2018,MALE,164,92,1004,472,1732,8.0
Matthias,2018,MALE,0,0,13,0,13,455.0
Maverick,2018,MALE,0,0,0,11,11,503.0
Max,2018,MALE,87,0,45,294,426,66.0
Maxim,2018,MALE,0,0,0,11,11,503.0
Maximilian,2018,MALE,0,0,22,34,56,221.0
Maximiliano,2018,MALE,0,0,26,0,26,296.0
Maximus,2018,MALE,0,45,51,36,132,143.0
Maxwell,2018,MALE,63,0,39,144,246,100.0
Mayer,2018,MALE,0,0,0,22,22,323.0
Md,2018,MALE,12,0,0,0,12,475.0
Mechel,2018,MALE,0,0,0,13,13,455.0
Meilech,2018,MALE,0,0,0,15,15,405.0
Meir,2018,MALE,0,0,0,64,64,205.0
Mekhi,2018,MALE,0,16,0,0,16,391.0
Menachem,2018,MALE,0,0,0,102,102,164.0
Mendel,2018,MALE,0,0,0,32,32,269.0
Mendy,2018,MALE,0,0,0,15,15,405.0
Messiah,2018,MALE,0,114,40,0,154,131.0
Meyer,2018,MALE,0,0,0,17,17,375.0
Micah,2018,MALE,0,68,0,40,108,158.0
Michael,2018,MALE,72,224,388,884,1568,13.0
Miguel,2018,MALE,0,0,40,0,40,256.0
Milan,2018,MALE,0,0,48,20,68,195.0
Miles,2018,MALE,30,33,0,249,312,86.0
Milo,2018,MALE,0,0,0,29,29,281.0
Mohamed,2018,MALE,0,94,0,82,176,119.0
Mohammad,2018,MALE,55,0,0,0,55,227.0
Mohammed,2018,MALE,52,0,0,28,80,178.0
Moises,2018,MALE,0,0,19,0,19,350.0
Moishe,2018,MALE,0,0,0,16,16,391.0
Mordche,2018,MALE,0,0,0,11,11,503.0
Mordechai,2018,MALE,0,0,0,122,122,149.0
Morris,2018,MALE,0,0,0,21,21,328.0
Moses,2018,MALE,0,0,0,28,28,287.0
Moshe,2018,MALE,0,0,0,220,220,105.0
Mouhamed,2018,MALE,0,10,0,0,10,539.0
Moussa,2018,MALE,0,13,0,0,13,455.0
Muhammad,2018,MALE,492,48,0,81,621,49.0
Musa,2018,MALE,52,22,0,0,74,187.0
Mustafa,2018,MALE,10,0,0,0,10,539.0
Myles,2018,MALE,0,20,0,34,54,228.0
Naftali,2018,MALE,0,0,0,32,32,269.0
Naftuli,2018,MALE,0,0,0,23,23,314.0
Nasir,2018,MALE,0,34,0,0,34,265.0
Nathan,2018,MALE,188,144,300,312,944,30.0
Nathaniel,2018,MALE,72,116,176,216,580,50.0
Nazir,2018,MALE,0,11,0,0,11,503.0
Nehemiah,2018,MALE,0,11,0,0,11,503.0
Nicholas,2018,MALE,84,100,248,444,876,32.0
Nico,2018,MALE,0,0,0,30,30,276.0
Nicolas,2018,MALE,0,0,94,44,138,137.0
Nikolas,2018,MALE,0,0,0,10,10,539.0
Noah,2018,MALE,276,644,1048,620,2588,2.0
Noam,2018,MALE,0,0,0,21,21,328.0
Noel,2018,MALE,0,22,44,0,66,198.0
Nolan,2018,MALE,72,48,100,132,352,77.0
Oliver,2018,MALE,120,0,210,405,735,38.0
Omar,2018,MALE,48,48,40,252,388,71.0
Omari,2018,MALE,0,28,0,0,28,287.0
Orion,2018,MALE,0,0,22,24,46,240.0
Oscar,2018,MALE,57,0,84,132,273,93.0
Otis,2018,MALE,0,0,0,10,10,539.0
Oumar,2018,MALE,0,16,0,0,16,391.0
Ousmane,2018,MALE,0,12,0,0,12,475.0
Owen,2018,MALE,156,0,63,189,408,68.0
Pablo,2018,MALE,0,0,18,0,18,363.0
Parker,2018,MALE,20,0,0,56,76,183.0
Patrick,2018,MALE,0,0,0,28,28,287.0
Paul,2018,MALE,0,0,0,26,26,296.0
Pedro,2018,MALE,0,0,18,0,18,363.0
Peter,2018,MALE,0,0,0,47,47,238.0
Philip,2018,MALE,0,0,0,14,14,427.0
Pinchas,2018,MALE,0,0,0,17,17,375.0
Pinchus,2018,MALE,0,0,0,21,21,328.0
Preston,2018,MALE,0,14,0,0,14,427.0
Prince,2018,MALE,0,84,38,0,122,149.0
Princeton,2018,MALE,0,14,0,0,14,427.0
Quincy,2018,MALE,0,10,0,0,10,539.0
Quinn,2018,MALE,0,0,0,11,11,503.0
Rafael,2018,MALE,0,0,66,68,134,141.0
Randy,2018,MALE,0,0,12,0,12,475.0
Raphael,2018,MALE,0,0,0,32,32,269.0
Rayan,2018,MALE,42,0,0,50,92,170.0
Raymond,2018,MALE,48,0,33,51,132,143.0
Rayyan,2018,MALE,14,0,0,0,14,427.0
Rehan,2018,MALE,12,0,0,0,12,475.0
Reid,2018,MALE,0,0,0,16,16,391.0
Remy,2018,MALE,0,0,0,21,21,328.0
Reuven,2018,MALE,0,0,0,14,14,427.0
Rhys,2018,MALE,0,0,0,10,10,539.0
Ricardo,2018,MALE,0,0,14,0,14,427.0
Richard,2018,MALE,0,33,30,66,129,146.0
Riley,2018,MALE,0,0,0,14,14,427.0
River,2018,MALE,0,0,0,16,16,391.0
Robert,2018,MALE,0,33,57,159,249,98.0
Rocco,2018,MALE,0,0,0,15,15,405.0
Rodrigo,2018,MALE,0,0,11,0,11,503.0
Rohan,2018,MALE,11,0,0,0,11,503.0
Roman,2018,MALE,0,45,51,60,156,130.0
Romeo,2018,MALE,0,0,10,0,10,539.0
Ronan,2018,MALE,0,0,0,21,21,328.0
Rory,2018,MALE,0,0,0,18,18,363.0
Rowan,2018,MALE,0,0,0,23,23,314.0
Ryan,2018,MALE,468,196,368,400,1432,15.0
Ryder,2018,MALE,20,0,0,24,44,246.0
Safwan,2018,MALE,21,0,0,0,21,328.0
Sage,2018,MALE,0,10,0,0,10,539.0
Sahil,2018,MALE,10,0,0,0,10,539.0
Saif,2018,MALE,12,0,0,0,12,475.0
Salvatore,2018,MALE,0,0,0,23,23,314.0
Sam,2018,MALE,0,0,0,23,23,314.0
Samir,2018,MALE,0,0,20,26,46,240.0
Sammy,2018,MALE,0,0,0,11,11,503.0
Samuel,2018,MALE,80,152,176,712,1120,23.0
Santiago,2018,MALE,0,0,76,0,76,183.0
Santino,2018,MALE,0,0,0,16,16,391.0
Sawyer,2018,MALE,0,0,0,10,10,539.0
Sean,2018,MALE,39,30,0,45,114,154.0
Sebastian,2018,MALE,68,76,968,228,1340,17.0
Selim,2018,MALE,0,0,0,15,15,405.0
Seth,2018,MALE,0,10,0,0,10,539.0
Shalom,2018,MALE,0,0,0,14,14,427.0
Shane,2018,MALE,0,0,0,16,16,391.0
Shaul,2018,MALE,0,0,0,13,13,455.0
Shaya,2018,MALE,0,0,0,44,44,246.0
Shea,2018,MALE,0,0,0,21,21,328.0
Shia,2018,MALE,0,0,0,27,27,293.0
Shimon,2018,MALE,0,0,0,95,95,168.0
Shloime,2018,MALE,0,0,0,16,16,391.0
Shloimy,2018,MALE,0,0,0,19,19,350.0
Shloma,2018,MALE,0,0,0,19,19,350.0
Shlome,2018,MALE,0,0,0,23,23,314.0
Shlomo,2018,MALE,0,0,0,72,72,189.0
Shmiel,2018,MALE,0,0,0,23,23,314.0
Shmuel,2018,MALE,0,0,0,54,54,228.0
Shneur,2018,MALE,0,0,0,10,10,539.0
Sholom,2018,MALE,0,0,0,12,12,475.0
Shulem,2018,MALE,0,0,0,36,36,262.0
Silas,2018,MALE,0,0,0,12,12,475.0
Simcha,2018,MALE,0,0,0,40,40,256.0
Simon,2018,MALE,0,0,0,43,43,249.0
Sincere,2018,MALE,0,17,0,0,17,375.0
Skyler,2018,MALE,10,0,0,0,10,539.0
Solomon,2018,MALE,0,0,0,31,31,273.0
Spencer,2018,MALE,0,0,0,19,19,350.0
Stefan,2018,MALE,0,0,0,10,10,539.0
Stephen,2018,MALE,0,33,48,39,120,151.0
Steven,2018,MALE,33,0,99,72,204,107.0
Syed,2018,MALE,25,0,0,0,25,304.0
Tenzin,2018,MALE,31,0,0,0,31,273.0
Theo,2018,MALE,0,0,0,30,30,276.0
Theodore,2018,MALE,111,0,36,483,630,48.0
Thiago,2018,MALE,0,0,108,0,108,158.0
Thomas,2018,MALE,0,0,48,200,248,99.0
Timothy,2018,MALE,39,36,0,72,147,133.0
Tomas,2018,MALE,0,0,11,0,11,503.0
Tristan,2018,MALE,64,156,92,64,376,74.0
Tyler,2018,MALE,52,124,96,108,380,72.0
Tzvi,2018,MALE,0,0,0,64,64,205.0
Umar,2018,MALE,0,0,0,11,11,503.0
Uriel,2018,MALE,0,0,14,0,14,427.0
Usher,2018,MALE,0,0,0,16,16,391.0
Veer,2018,MALE,13,0,0,0,13,455.0
Victor,2018,MALE,0,0,64,56,120,151.0
Vincent,2018,MALE,90,0,36,174,300,87.0
Walter,2018,MALE,0,0,0,16,16,391.0
Wesley,2018,MALE,51,0,48,81,180,118.0
Weston,2018,MALE,0,0,0,10,10,539.0
Wilder,2018,MALE,0,0,0,11,11,503.0
William,2018,MALE,208,104,172,760,1244,21.0
Wilson,2018,MALE,10,0,0,0,10,539.0
Winston,2018,MALE,18,0,0,0,18,363.0
Wyatt,2018,MALE,0,0,0,34,34,265.0
Xander,2018,MALE,22,0,28,0,50,236.0
Xavier,2018,MALE,44,136,244,52,476,60.0
Yaakov,2018,MALE,0,0,0,59,59,216.0
Yadiel,2018,MALE,0,0,21,0,21,328.0
Yael,2018,MALE,0,0,12,0,12,475.0
Yakov,2018,MALE,0,0,0,66,66,198.0
Yanky,2018,MALE,0,0,0,11,11,503.0
Yariel,2018,MALE,0,0,12,0,12,475.0
Yechiel,2018,MALE,0,0,0,23,23,314.0
Yehoshua,2018,MALE,0,0,0,14,14,427.0
Yehuda,2018,MALE,0,0,0,92,92,170.0
Yidel,2018,MALE,0,0,0,12,12,475.0
Yisrael,2018,MALE,0,0,0,10,10,539.0
Yisroel,2018,MALE,0,0,0,82,82,177.0
Yitzchak,2018,MALE,0,0,0,13,13,455.0
Yitzchok,2018,MALE,0,0,0,88,88,175.0
Yoel,2018,MALE,0,0,0,15,15,405.0
Yosef,2018,MALE,0,0,0,101,101,165.0
Yossi,2018,MALE,0,0,0,18,18,363.0
Yousef,2018,MALE,0,0,0,19,19,350.0
Youssef,2018,MALE,0,0,0,24,24,309.0
Yusuf,2018,MALE,36,0,0,58,94,169.0
Zachary,2018,MALE,88,72,92,272,524,58.0
Zaid,2018,MALE,0,0,18,0,18,363.0
Zaiden,2018,MALE,0,15,0,0,15,405.0
Zain,2018,MALE,32,0,0,34,66,198.0
Zaire,2018,MALE,0,20,0,0,20,340.0
Zalmen,2018,MALE,0,0,0,14,14,427.0
Zane,2018,MALE,0,36,0,20,56,221.0
Zayan,2018,MALE,18,0,0,0,18,363.0
Zayden,2018,MALE,0,28,48,0,76,183.0
Zayn,2018,MALE,34,0,0,38,72,189.0
Zev,2018,MALE,0,0,0,59,59,216.0
Zion,2018,MALE,0,112,36,0,148,132.0
Aaliyah,2019,FEMALE,33,87,105,0,225,71.0
Abby,2019,FEMALE,28,0,20,0,48,205.0
Abigail,2019,FEMALE,116,92,344,288,840,15.0
Ada,2019,FEMALE,26,0,0,56,82,144.0
Addison,2019,FEMALE,0,0,0,18,18,351.0
Adelaide,2019,FEMALE,0,0,0,19,19,336.0
Adele,2019,FEMALE,0,0,20,60,80,148.0
Adeline,2019,FEMALE,0,0,26,46,72,161.0
Adelynn,2019,FEMALE,0,0,11,0,11,515.0
Adina,2019,FEMALE,0,0,0,21,21,306.0
Adriana,2019,FEMALE,0,0,42,40,82,144.0
Ahuva,2019,FEMALE,0,0,0,19,19,336.0
Aicha,2019,FEMALE,0,15,0,0,15,401.0
Ailani,2019,FEMALE,0,0,11,0,11,515.0
Aileen,2019,FEMALE,0,0,12,0,12,477.0
Aisha,2019,FEMALE,30,78,0,63,171,95.0
Aiza,2019,FEMALE,17,0,0,0,17,365.0
Alahia,2019,FEMALE,0,0,10,0,10,569.0
Alaia,2019,FEMALE,0,0,94,0,94,137.0
Alana,2019,FEMALE,0,0,21,0,21,306.0
Alani,2019,FEMALE,0,34,26,0,60,185.0
Alanna,2019,FEMALE,0,0,14,0,14,424.0
Alayna,2019,FEMALE,20,0,24,0,44,224.0
Aleah,2019,FEMALE,0,0,19,0,19,336.0
Aleena,2019,FEMALE,13,0,0,0,13,449.0
Alessandra,2019,FEMALE,0,0,0,22,22,292.0
Alessia,2019,FEMALE,0,0,32,58,90,139.0
Alexa,2019,FEMALE,0,0,45,0,45,218.0
Alexandra,2019,FEMALE,36,0,72,222,330,51.0
Alexis,2019,FEMALE,0,13,0,0,13,449.0
Alia,2019,FEMALE,0,0,16,0,16,380.0
Alice,2019,FEMALE,72,0,81,117,270,60.0
Alicia,2019,FEMALE,0,0,11,0,11,515.0
Alina,2019,FEMALE,69,0,75,39,183,89.0
Alisha,2019,FEMALE,11,0,0,0,11,515.0
Alison,2019,FEMALE,0,0,30,0,30,257.0
Aliya,2019,FEMALE,20,0,0,20,40,233.0
Aliyah,2019,FEMALE,0,28,54,0,82,144.0
Aliza,2019,FEMALE,34,0,0,28,62,181.0
Allison,2019,FEMALE,39,0,162,36,237,67.0
Alma,2019,FEMALE,0,0,30,42,72,161.0
Alondra,2019,FEMALE,0,0,15,0,15,401.0
Alyssa,2019,FEMALE,78,0,66,39,183,89.0
Amaia,2019,FEMALE,0,0,36,0,36,241.0
Amalia,2019,FEMALE,0,0,35,0,35,244.0
Amanda,2019,FEMALE,0,0,24,0,24,274.0
Amani,2019,FEMALE,0,10,0,0,10,569.0
Amara,2019,FEMALE,40,60,48,40,188,86.0
Amaya,2019,FEMALE,63,51,150,0,264,61.0
Amayah,2019,FEMALE,0,11,0,0,11,515.0
Amber,2019,FEMALE,0,0,16,0,16,380.0
Amelia,2019,FEMALE,240,164,396,372,1172,8.0
Amelie,2019,FEMALE,0,0,0,15,15,401.0
Amina,2019,FEMALE,0,60,0,60,120,124.0
Aminata,2019,FEMALE,0,23,0,0,23,284.0
Amira,2019,FEMALE,0,69,48,45,162,100.0
Amirah,2019,FEMALE,0,13,0,0,13,449.0
Amiyah,2019,FEMALE,0,20,0,0,20,320.0
Amora,2019,FEMALE,0,15,0,0,15,401.0
Amy,2019,FEMALE,30,0,100,0,130,118.0
Ana,2019,FEMALE,0,0,74,30,104,129.0
Anabia,2019,FEMALE,20,0,0,0,20,320.0
Analia,2019,FEMALE,0,0,13,0,13,449.0
Anastasia,2019,FEMALE,0,0,32,40,72,161.0
Anaya,2019,FEMALE,44,24,0,0,68,173.0
Andrea,2019,FEMALE,0,0,33,0,33,251.0
Angela,2019,FEMALE,42,0,36,0,78,152.0
Angelica,2019,FEMALE,0,0,13,0,13,449.0
Angelina,2019,FEMALE,45,0,51,72,168,96.0
Angie,2019,FEMALE,22,0,34,0,56,192.0
Aniyah,2019,FEMALE,0,11,0,0,11,515.0
Anna,2019,FEMALE,58,0,0,122,180,92.0
Annabel,2019,FEMALE,0,0,0,13,13,449.0
Annabelle,2019,FEMALE,0,0,0,23,23,284.0
Annalise,2019,FEMALE,0,0,13,0,13,449.0
Annie,2019,FEMALE,22,0,0,0,22,292.0
Antonella,2019,FEMALE,0,0,25,0,25,270.0
Anya,2019,FEMALE,0,0,0,11,11,515.0
April,2019,FEMALE,0,0,13,0,13,449.0
Aria,2019,FEMALE,160,132,144,232,668,22.0
Ariah,2019,FEMALE,0,22,0,0,22,292.0
Ariana,2019,FEMALE,76,72,296,156,600,28.0
Arianna,2019,FEMALE,0,36,117,66,219,75.0
Ariel,2019,FEMALE,48,48,39,0,135,114.0
Ariella,2019,FEMALE,39,0,60,102,201,80.0
Arielle,2019,FEMALE,0,18,0,0,18,351.0
Ariyah,2019,FEMALE,0,10,0,0,10,569.0
Arlette,2019,FEMALE,0,0,11,0,11,515.0
Arya,2019,FEMALE,148,68,172,56,444,41.0
Ashley,2019,FEMALE,32,0,152,0,184,88.0
Astrid,2019,FEMALE,0,0,0,10,10,569.0
Athena,2019,FEMALE,39,0,78,36,153,104.0
Aubree,2019,FEMALE,0,0,11,0,11,515.0
Aubrey,2019,FEMALE,0,45,54,33,132,115.0
Audrey,2019,FEMALE,90,0,42,90,222,74.0
Aurelia,2019,FEMALE,0,0,0,12,12,477.0
Aurora,2019,FEMALE,52,44,92,116,304,53.0
Autumn,2019,FEMALE,0,72,48,42,162,100.0
Ava,2019,FEMALE,164,400,404,428,1396,7.0
Avery,2019,FEMALE,116,64,96,260,536,33.0
Aviva,2019,FEMALE,0,0,0,15,15,401.0
Aya,2019,FEMALE,0,0,0,11,11,515.0
Ayala,2019,FEMALE,0,0,0,12,12,477.0
Ayat,2019,FEMALE,16,0,0,0,16,380.0
Ayesha,2019,FEMALE,22,0,0,0,22,292.0
Ayla,2019,FEMALE,0,0,22,56,78,152.0
Ayra,2019,FEMALE,10,0,0,0,10,569.0
Baila,2019,FEMALE,0,0,0,69,69,172.0
Batsheva,2019,FEMALE,0,0,0,17,17,365.0
Beatrice,2019,FEMALE,0,0,0,32,32,253.0
Bella,2019,FEMALE,160,88,208,128,584,29.0
Bianca,2019,FEMALE,0,0,22,24,46,215.0
Bina,2019,FEMALE,0,0,0,12,12,477.0
Bintou,2019,FEMALE,0,14,0,0,14,424.0
Blair,2019,FEMALE,0,0,0,10,10,569.0
Blake,2019,FEMALE,0,0,0,17,17,365.0
Blima,2019,FEMALE,0,0,0,21,21,306.0
Blimy,2019,FEMALE,0,0,0,19,19,336.0
Bracha,2019,FEMALE,0,0,0,23,23,284.0
Breindy,2019,FEMALE,0,0,0,21,21,306.0
Briana,2019,FEMALE,0,0,16,0,16,380.0
Brianna,2019,FEMALE,0,33,129,30,192,84.0
Brielle,2019,FEMALE,0,87,48,33,168,96.0
Brooke,2019,FEMALE,0,0,0,12,12,477.0
Brooklyn,2019,FEMALE,0,0,0,10,10,569.0
Bruchy,2019,FEMALE,0,0,0,24,24,274.0
Cali,2019,FEMALE,0,24,22,0,46,215.0
Camila,2019,FEMALE,0,0,324,22,346,49.0
Camilla,2019,FEMALE,0,0,0,14,14,424.0
Camille,2019,FEMALE,0,0,0,10,10,569.0
Caroline,2019,FEMALE,0,0,0,35,35,244.0
Cataleya,2019,FEMALE,0,0,10,0,10,569.0
Catalina,2019,FEMALE,0,0,19,0,19,336.0
Catherine,2019,FEMALE,30,0,0,48,78,152.0
Cecilia,2019,FEMALE,24,0,0,54,78,152.0
Celeste,2019,FEMALE,0,0,0,10,10,569.0
Celia,2019,FEMALE,0,0,0,11,11,515.0
Celine,2019,FEMALE,72,0,78,75,225,71.0
Chana,2019,FEMALE,0,0,0,124,124,121.0
Chany,2019,FEMALE,0,0,0,45,45,218.0
Charlie,2019,FEMALE,0,0,0,14,14,424.0
Charlotte,2019,FEMALE,171,0,204,474,849,14.0
Chava,2019,FEMALE,0,0,0,42,42,227.0
Chavy,2019,FEMALE,0,0,0,22,22,292.0
Chaya,2019,FEMALE,0,0,0,209,209,79.0
Chelsea,2019,FEMALE,0,11,0,0,11,515.0
Chloe,2019,FEMALE,524,136,244,256,1160,9.0
Claire,2019,FEMALE,70,0,0,74,144,107.0
Clara,2019,FEMALE,0,0,0,45,45,218.0
Colette,2019,FEMALE,0,0,0,18,18,351.0
Cora,2019,FEMALE,0,0,0,16,16,380.0
Crystal,2019,FEMALE,0,0,10,0,10,569.0
Cynthia,2019,FEMALE,16,0,0,0,16,380.0
Dahlia,2019,FEMALE,0,0,30,20,50,201.0
Daisy,2019,FEMALE,12,0,0,0,12,477.0
Dalia,2019,FEMALE,0,0,0,11,11,515.0
Dana,2019,FEMALE,0,0,0,12,12,477.0
Daniela,2019,FEMALE,0,0,43,0,43,225.0
Daniella,2019,FEMALE,0,0,36,26,62,181.0
Danna,2019,FEMALE,0,0,20,0,20,320.0
Daphne,2019,FEMALE,0,0,0,13,13,449.0
Dara,2019,FEMALE,0,0,12,0,12,477.0
Dayana,2019,FEMALE,0,0,15,0,15,401.0
Delilah,2019,FEMALE,0,0,13,0,13,449.0
Destiny,2019,FEMALE,0,34,36,0,70,168.0
Devoiry,2019,FEMALE,0,0,0,12,12,477.0
Devora,2019,FEMALE,0,0,0,18,18,351.0
Devorah,2019,FEMALE,0,0,0,47,47,211.0
Devory,2019,FEMALE,0,0,0,10,10,569.0
Diana,2019,FEMALE,0,0,56,40,96,136.0
Dina,2019,FEMALE,0,0,0,51,51,200.0
Dior,2019,FEMALE,0,15,0,0,15,401.0
Dream,2019,FEMALE,0,16,0,0,16,380.0
Dua,2019,FEMALE,20,0,0,22,42,227.0
Dylan,2019,FEMALE,0,0,0,21,21,306.0
Eden,2019,FEMALE,0,20,0,36,56,192.0
Edith,2019,FEMALE,0,0,0,18,18,351.0
Egypt,2019,FEMALE,0,11,0,0,11,515.0
Eileen,2019,FEMALE,0,0,14,0,14,424.0
Eleanor,2019,FEMALE,34,0,0,140,174,94.0
Elena,2019,FEMALE,63,0,156,57,276,57.0
Eliana,2019,FEMALE,68,44,176,232,520,34.0
Elianny,2019,FEMALE,0,0,12,0,12,477.0
Elina,2019,FEMALE,11,0,0,0,11,515.0
Elisa,2019,FEMALE,0,0,14,0,14,424.0
Elise,2019,FEMALE,26,0,0,30,56,192.0
Elisheva,2019,FEMALE,0,0,0,20,20,320.0
Eliza,2019,FEMALE,0,0,30,46,76,159.0
Elizabeth,2019,FEMALE,52,48,240,292,632,25.0
Ella,2019,FEMALE,168,64,104,472,808,16.0
Elle,2019,FEMALE,0,0,0,23,23,284.0
Ellie,2019,FEMALE,102,0,54,90,246,65.0
Elliott,2019,FEMALE,0,0,0,13,13,449.0
Eloise,2019,FEMALE,0,0,0,35,35,244.0
Emely,2019,FEMALE,0,0,36,0,36,241.0
Emerson,2019,FEMALE,0,0,0,14,14,424.0
Emery,2019,FEMALE,0,0,0,12,12,477.0
Emilia,2019,FEMALE,72,0,135,219,426,42.0
Emily,2019,FEMALE,212,52,324,432,1020,11.0
Emma,2019,FEMALE,284,80,852,744,1960,1.0
Emmy,2019,FEMALE,0,0,0,17,17,365.0
Erin,2019,FEMALE,12,0,0,0,12,477.0
Esme,2019,FEMALE,0,0,0,16,16,380.0
Esmeralda,2019,FEMALE,0,0,15,0,15,401.0
Estelle,2019,FEMALE,0,0,0,12,12,477.0
Ester,2019,FEMALE,0,0,0,11,11,515.0
Esther,2019,FEMALE,33,0,60,606,699,21.0
Esty,2019,FEMALE,0,0,0,42,42,227.0
Etty,2019,FEMALE,0,0,0,21,21,306.0
Eva,2019,FEMALE,88,48,132,240,508,35.0
Evangeline,2019,FEMALE,0,0,11,0,11,515.0
Eve,2019,FEMALE,0,0,0,19,19,336.0
Evelyn,2019,FEMALE,123,0,99,177,399,45.0
Everly,2019,FEMALE,0,0,22,30,52,199.0
Evie,2019,FEMALE,0,0,0,13,13,449.0
Faiga,2019,FEMALE,0,0,0,21,21,306.0
Faigy,2019,FEMALE,0,0,0,86,86,141.0
Faith,2019,FEMALE,0,20,0,0,20,320.0
Fatima,2019,FEMALE,102,99,0,30,231,69.0
Fatoumata,2019,FEMALE,0,35,0,0,35,244.0
Fernanda,2019,FEMALE,0,0,11,0,11,515.0
Fiona,2019,FEMALE,46,0,0,56,102,130.0
Fradel,2019,FEMALE,0,0,0,12,12,477.0
Frady,2019,FEMALE,0,0,0,16,16,380.0
Fraidy,2019,FEMALE,0,0,0,30,30,257.0
Frances,2019,FEMALE,0,0,0,25,25,270.0
Francesca,2019,FEMALE,0,0,0,29,29,261.0
Frida,2019,FEMALE,0,0,0,15,15,401.0
Frieda,2019,FEMALE,0,0,0,10,10,569.0
Frimet,2019,FEMALE,0,0,0,19,19,336.0
Gabriela,2019,FEMALE,0,0,54,24,78,152.0
Gabriella,2019,FEMALE,0,57,135,162,354,48.0
Gabrielle,2019,FEMALE,0,36,0,24,60,185.0
Gemma,2019,FEMALE,0,0,0,24,24,274.0
Genesis,2019,FEMALE,0,42,176,0,218,76.0
Genevieve,2019,FEMALE,0,0,0,16,16,380.0
Georgia,2019,FEMALE,0,0,0,18,18,351.0
Georgina,2019,FEMALE,0,0,0,12,12,477.0
Gia,2019,FEMALE,0,20,20,0,40,233.0
Gianna,2019,FEMALE,0,66,159,87,312,52.0
Giovanna,2019,FEMALE,0,0,0,10,10,569.0
Giselle,2019,FEMALE,0,0,18,0,18,351.0
Gittel,2019,FEMALE,0,0,0,16,16,380.0
Gitty,2019,FEMALE,0,0,0,99,99,134.0
Giuliana,2019,FEMALE,0,0,0,14,14,424.0
Golda,2019,FEMALE,0,0,0,12,12,477.0
Goldie,2019,FEMALE,0,0,0,11,11,515.0
Goldy,2019,FEMALE,0,0,0,28,28,263.0
Grace,2019,FEMALE,192,112,192,264,760,18.0
Guadalupe,2019,FEMALE,0,0,12,0,12,477.0
Hadassah,2019,FEMALE,0,0,0,18,18,351.0
Hailey,2019,FEMALE,152,52,264,104,572,30.0
Hanna,2019,FEMALE,0,0,0,15,15,401.0
Hannah,2019,FEMALE,164,72,132,276,644,24.0
Harley,2019,FEMALE,0,0,10,0,10,569.0
Harmony,2019,FEMALE,0,23,0,0,23,284.0
Harper,2019,FEMALE,34,0,0,98,132,115.0
Hawa,2019,FEMALE,0,10,0,0,10,569.0
Hazel,2019,FEMALE,20,0,0,70,90,139.0
Heaven,2019,FEMALE,0,0,13,0,13,449.0
Heidy,2019,FEMALE,0,0,11,0,11,515.0
Helen,2019,FEMALE,10,0,0,0,10,569.0
Helena,2019,FEMALE,0,0,0,11,11,515.0
Hendy,2019,FEMALE,0,0,0,11,11,515.0
Henny,2019,FEMALE,0,0,0,27,27,266.0
Hinda,2019,FEMALE,0,0,0,20,20,320.0
Hindy,2019,FEMALE,0,0,0,47,47,211.0
Hoorain,2019,FEMALE,10,0,0,0,10,569.0
Hope,2019,FEMALE,0,13,0,0,13,449.0
Idy,2019,FEMALE,0,0,0,14,14,424.0
Imani,2019,FEMALE,0,16,0,0,16,380.0
Imona,2019,FEMALE,0,0,0,19,19,336.0
Inaaya,2019,FEMALE,24,0,0,0,24,274.0
Inaya,2019,FEMALE,20,0,0,0,20,320.0
Ines,2019,FEMALE,0,0,0,11,11,515.0
Irene,2019,FEMALE,17,0,0,0,17,365.0
Iris,2019,FEMALE,24,0,0,40,64,180.0
Isabel,2019,FEMALE,0,0,58,80,138,109.0
Isabela,2019,FEMALE,0,0,12,0,12,477.0
Isabella,2019,FEMALE,172,152,924,344,1592,5.0
Isabelle,2019,FEMALE,0,42,36,102,180,92.0
Isla,2019,FEMALE,24,0,0,106,130,118.0
Itzel,2019,FEMALE,0,0,18,0,18,351.0
Ivy,2019,FEMALE,26,0,0,30,56,192.0
Iymona,2019,FEMALE,0,0,0,13,13,449.0
Izabella,2019,FEMALE,0,0,10,0,10,569.0
Jacqueline,2019,FEMALE,0,0,0,11,11,515.0
Jada,2019,FEMALE,0,11,0,0,11,515.0
Jade,2019,FEMALE,0,60,117,39,216,77.0
Jaliyah,2019,FEMALE,0,13,0,0,13,449.0
Jana,2019,FEMALE,0,0,0,16,16,380.0
Jane,2019,FEMALE,0,0,0,28,28,263.0
Janice,2019,FEMALE,10,0,0,0,10,569.0
Janiyah,2019,FEMALE,0,11,0,0,11,515.0
Jannat,2019,FEMALE,10,0,0,0,10,569.0
Jannatul,2019,FEMALE,17,0,0,0,17,365.0
Jasmine,2019,FEMALE,96,52,88,48,284,55.0
Jayla,2019,FEMALE,0,38,32,0,70,168.0
Jayleen,2019,FEMALE,0,0,32,0,32,253.0
Jaylin,2019,FEMALE,0,0,11,0,11,515.0
Jazlyn,2019,FEMALE,0,0,27,0,27,266.0
Jazmin,2019,FEMALE,0,0,16,0,16,380.0
Jenna,2019,FEMALE,0,0,0,17,17,365.0
Jennifer,2019,FEMALE,0,0,11,0,11,515.0
Jessica,2019,FEMALE,48,0,36,39,123,122.0
Jewel,2019,FEMALE,0,12,0,0,12,477.0
Joanna,2019,FEMALE,23,0,0,0,23,284.0
Jocelyn,2019,FEMALE,16,0,0,0,16,380.0
Jordyn,2019,FEMALE,0,18,0,0,18,351.0
Josephine,2019,FEMALE,20,0,0,108,128,120.0
Journee,2019,FEMALE,0,20,0,0,20,320.0
Journey,2019,FEMALE,0,14,0,0,14,424.0
Joy,2019,FEMALE,12,0,0,0,12,477.0
Julia,2019,FEMALE,42,0,45,189,276,57.0
Juliana,2019,FEMALE,0,0,32,48,80,148.0
Julianna,2019,FEMALE,0,0,20,28,48,205.0
Juliet,2019,FEMALE,0,0,60,46,106,128.0
Juliette,2019,FEMALE,0,0,50,88,138,109.0
Julissa,2019,FEMALE,0,0,13,0,13,449.0
June,2019,FEMALE,0,0,0,23,23,284.0
Juniper,2019,FEMALE,0,0,0,10,10,569.0
Kaia,2019,FEMALE,0,0,0,20,20,320.0
Kailani,2019,FEMALE,0,0,17,0,17,365.0
Kaitlyn,2019,FEMALE,0,0,12,0,12,477.0
Kalani,2019,FEMALE,0,11,0,0,11,515.0
Kali,2019,FEMALE,0,38,20,0,58,189.0
Kamila,2019,FEMALE,0,0,56,26,82,144.0
Kamiyah,2019,FEMALE,0,10,0,0,10,569.0
Karen,2019,FEMALE,24,0,24,0,48,205.0
Katherine,2019,FEMALE,54,0,51,51,156,102.0
Kayla,2019,FEMALE,132,96,116,116,460,39.0
Kaylani,2019,FEMALE,0,0,24,0,24,274.0
Kaylee,2019,FEMALE,39,48,147,0,234,68.0
Kehlani,2019,FEMALE,0,48,30,0,78,152.0
Keily,2019,FEMALE,0,0,10,0,10,569.0
Keira,2019,FEMALE,0,0,0,15,15,401.0
Kelly,2019,FEMALE,11,0,0,0,11,515.0
Kennedy,2019,FEMALE,0,19,0,0,19,336.0
Kenzie,2019,FEMALE,0,10,0,0,10,569.0
Keyla,2019,FEMALE,0,0,16,0,16,380.0
Khadija,2019,FEMALE,30,20,0,0,50,201.0
Khadijah,2019,FEMALE,0,15,0,0,15,401.0
Khaleesi,2019,FEMALE,0,20,26,0,46,215.0
Khloe,2019,FEMALE,0,34,58,0,92,138.0
Kiara,2019,FEMALE,24,0,56,0,80,148.0
Kimberly,2019,FEMALE,0,0,42,0,42,227.0
Kimora,2019,FEMALE,0,15,0,0,15,401.0
Kira,2019,FEMALE,22,0,0,20,42,227.0
Kori,2019,FEMALE,0,12,0,0,12,477.0
Kylie,2019,FEMALE,51,75,114,0,240,66.0
Laia,2019,FEMALE,0,0,10,0,10,569.0
Laila,2019,FEMALE,0,42,45,60,147,106.0
Lana,2019,FEMALE,0,0,0,19,19,336.0
Lara,2019,FEMALE,0,0,0,15,15,401.0
Laura,2019,FEMALE,0,0,0,14,14,424.0
Lauren,2019,FEMALE,0,22,26,0,48,205.0
Lauryn,2019,FEMALE,0,10,0,0,10,569.0
Layan,2019,FEMALE,0,0,0,21,21,306.0
Layla,2019,FEMALE,68,116,148,240,572,30.0
Lea,2019,FEMALE,0,0,0,22,22,292.0
Leah,2019,FEMALE,88,128,376,828,1420,6.0
Leia,2019,FEMALE,0,0,0,11,11,515.0
Leila,2019,FEMALE,0,45,39,57,141,108.0
Leilani,2019,FEMALE,0,46,70,0,116,126.0
Lena,2019,FEMALE,20,0,0,38,58,189.0
Leslie,2019,FEMALE,0,0,19,0,19,336.0
Lesly,2019,FEMALE,0,0,12,0,12,477.0
Lia,2019,FEMALE,0,0,62,36,98,135.0
Liah,2019,FEMALE,0,0,13,0,13,449.0
Liana,2019,FEMALE,0,0,36,36,72,161.0
Liba,2019,FEMALE,0,0,0,19,19,336.0
Libby,2019,FEMALE,0,0,0,40,40,233.0
Lielle,2019,FEMALE,0,0,0,10,10,569.0
Lila,2019,FEMALE,0,0,0,30,30,257.0
Lilah,2019,FEMALE,0,0,0,16,16,380.0
Liliana,2019,FEMALE,0,0,40,60,100,132.0
Lillian,2019,FEMALE,0,0,0,45,45,218.0
Lilly,2019,FEMALE,0,0,0,15,15,401.0
Lily,2019,FEMALE,36,0,42,285,363,47.0
Lina,2019,FEMALE,0,0,0,24,24,274.0
Litzy,2019,FEMALE,0,0,10,0,10,569.0
Liv,2019,FEMALE,0,0,0,25,25,270.0
Livia,2019,FEMALE,0,0,0,11,11,515.0
Lizbeth,2019,FEMALE,0,0,14,0,14,424.0
Lola,2019,FEMALE,0,0,0,14,14,424.0
London,2019,FEMALE,0,40,40,0,80,148.0
Londyn,2019,FEMALE,0,12,0,0,12,477.0
Louisa,2019,FEMALE,0,0,0,14,14,424.0
Louise,2019,FEMALE,0,0,0,18,18,351.0
Lucia,2019,FEMALE,0,0,56,60,116,126.0
Luciana,2019,FEMALE,0,0,32,30,62,181.0
Lucille,2019,FEMALE,0,0,0,11,11,515.0
Lucy,2019,FEMALE,0,0,0,54,54,197.0
Luna,2019,FEMALE,88,48,616,176,928,13.0
Luz,2019,FEMALE,0,0,13,0,13,449.0
Lyanna,2019,FEMALE,0,0,10,0,10,569.0
Lydia,2019,FEMALE,20,0,0,20,40,233.0
Lyla,2019,FEMALE,0,0,0,30,30,257.0
Lyric,2019,FEMALE,0,16,0,0,16,380.0
Mackenzie,2019,FEMALE,0,45,30,57,132,115.0
Madeleine,2019,FEMALE,20,0,0,52,72,161.0
Madeline,2019,FEMALE,32,0,0,68,100,132.0
Madelyn,2019,FEMALE,0,0,34,34,68,173.0
Madison,2019,FEMALE,60,236,216,232,744,19.0
Maeve,2019,FEMALE,0,0,0,29,29,261.0
Maia,2019,FEMALE,0,0,21,0,21,306.0
Makayla,2019,FEMALE,0,20,0,0,20,320.0
Malak,2019,FEMALE,0,0,0,12,12,477.0
Malia,2019,FEMALE,0,38,30,0,68,173.0
Malika,2019,FEMALE,0,0,0,14,14,424.0
Maliyah,2019,FEMALE,0,18,0,0,18,351.0
Malka,2019,FEMALE,0,0,0,60,60,185.0
Malky,2019,FEMALE,0,0,0,77,77,158.0
Manha,2019,FEMALE,19,0,0,0,19,336.0
Margaret,2019,FEMALE,0,0,0,35,35,244.0
Margot,2019,FEMALE,0,0,0,47,47,211.0
Maria,2019,FEMALE,0,0,58,80,138,109.0
Mariam,2019,FEMALE,36,90,0,66,192,84.0
Mariama,2019,FEMALE,0,15,0,0,15,401.0
Mariana,2019,FEMALE,0,0,18,0,18,351.0
Mary,2019,FEMALE,0,0,0,17,17,365.0
Maryam,2019,FEMALE,99,36,0,60,195,82.0
Matilda,2019,FEMALE,0,0,0,14,14,424.0
Maya,2019,FEMALE,104,60,160,384,708,20.0
Mckenzie,2019,FEMALE,0,11,0,0,11,515.0
Meghan,2019,FEMALE,0,0,13,0,13,449.0
Meira,2019,FEMALE,0,0,0,11,11,515.0
Melanie,2019,FEMALE,0,28,110,0,138,109.0
Melany,2019,FEMALE,0,0,20,0,20,320.0
Melissa,2019,FEMALE,0,0,28,22,50,201.0
Melody,2019,FEMALE,45,93,87,0,225,71.0
Mia,2019,FEMALE,352,116,736,536,1740,4.0
Miah,2019,FEMALE,0,0,12,0,12,477.0
Michal,2019,FEMALE,0,0,0,11,11,515.0
Michelle,2019,FEMALE,52,56,104,64,276,57.0
Mila,2019,FEMALE,63,0,198,237,498,37.0
Milan,2019,FEMALE,0,15,0,0,15,401.0
Milana,2019,FEMALE,0,0,0,11,11,515.0
Milani,2019,FEMALE,0,28,20,0,48,205.0
Millie,2019,FEMALE,0,0,0,11,11,515.0
Mindy,2019,FEMALE,0,0,0,24,24,274.0
Mira,2019,FEMALE,0,0,0,15,15,401.0
Miracle,2019,FEMALE,0,50,22,0,72,161.0
Miranda,2019,FEMALE,0,0,11,0,11,515.0
Miri,2019,FEMALE,0,0,0,10,10,569.0
Miriam,2019,FEMALE,0,0,0,193,193,83.0
Miya,2019,FEMALE,11,0,0,0,11,515.0
Molly,2019,FEMALE,0,0,0,37,37,240.0
Morgan,2019,FEMALE,0,22,0,26,48,205.0
Muntaha,2019,FEMALE,10,0,0,0,10,569.0
Muslima,2019,FEMALE,0,0,0,12,12,477.0
Mya,2019,FEMALE,0,40,28,0,68,173.0
Nabiha,2019,FEMALE,10,0,0,0,10,569.0
Nadia,2019,FEMALE,0,0,0,13,13,449.0
Nailah,2019,FEMALE,0,10,0,0,10,569.0
Nala,2019,FEMALE,0,10,0,0,10,569.0
Naomi,2019,FEMALE,52,92,76,192,412,44.0
Nashla,2019,FEMALE,0,0,14,0,14,424.0
Natalia,2019,FEMALE,0,0,54,20,74,160.0
Natalie,2019,FEMALE,51,0,105,123,279,56.0
Nava,2019,FEMALE,0,0,0,12,12,477.0
Nechama,2019,FEMALE,0,0,0,26,26,269.0
Nevaeh,2019,FEMALE,0,22,0,0,22,292.0
Nia,2019,FEMALE,0,12,0,0,12,477.0
Nicole,2019,FEMALE,30,0,66,72,168,96.0
Nina,2019,FEMALE,54,0,30,99,183,89.0
Noa,2019,FEMALE,0,0,0,50,50,201.0
Noelle,2019,FEMALE,0,0,0,10,10,569.0
Noor,2019,FEMALE,0,0,0,11,11,515.0
Nora,2019,FEMALE,28,0,0,126,154,103.0
Norah,2019,FEMALE,11,0,0,0,11,515.0
Nova,2019,FEMALE,0,90,66,42,198,81.0
Nyla,2019,FEMALE,0,54,32,0,86,141.0
Nylah,2019,FEMALE,0,38,30,0,68,173.0
Olive,2019,FEMALE,0,0,0,22,22,292.0
Olivia,2019,FEMALE,436,160,404,800,1800,2.0
Ophelia,2019,FEMALE,12,0,0,0,12,477.0
Oumou,2019,FEMALE,0,10,0,0,10,569.0
Paige,2019,FEMALE,0,36,0,34,70,168.0
Paris,2019,FEMALE,0,17,0,0,17,365.0
Parker,2019,FEMALE,0,0,0,22,22,292.0
Pearl,2019,FEMALE,0,0,0,28,28,263.0
Penelope,2019,FEMALE,57,0,219,267,543,32.0
Perel,2019,FEMALE,0,0,0,17,17,365.0
Perry,2019,FEMALE,0,0,0,12,12,477.0
Pessy,2019,FEMALE,0,0,0,21,21,306.0
Peyton,2019,FEMALE,0,36,0,22,58,189.0
Phoebe,2019,FEMALE,34,0,0,34,68,173.0
Phoenix,2019,FEMALE,0,22,0,0,22,292.0
Piper,2019,FEMALE,0,0,0,16,16,380.0
Poppy,2019,FEMALE,0,0,0,20,20,320.0
Quinn,2019,FEMALE,0,0,0,33,33,251.0
Rachel,2019,FEMALE,45,0,48,513,606,27.0
Raizel,2019,FEMALE,0,0,0,18,18,351.0
Raizy,2019,FEMALE,0,0,0,53,53,198.0
Rebecca,2019,FEMALE,0,0,0,41,41,232.0
Reem,2019,FEMALE,0,0,0,11,11,515.0
Reese,2019,FEMALE,0,0,0,19,19,336.0
Reign,2019,FEMALE,0,24,0,0,24,274.0
Reizy,2019,FEMALE,0,0,0,10,10,569.0
Remi,2019,FEMALE,0,0,0,15,15,401.0
Remy,2019,FEMALE,0,0,0,13,13,449.0
Rhea,2019,FEMALE,11,0,0,0,11,515.0
Riley,2019,FEMALE,96,188,168,204,656,23.0
Riva,2019,FEMALE,0,0,0,10,10,569.0
Rivka,2019,FEMALE,0,0,0,138,138,109.0
Rivky,2019,FEMALE,0,0,0,72,72,161.0
Rochel,2019,FEMALE,0,0,0,20,20,320.0
Roizy,2019,FEMALE,0,0,0,15,15,401.0
Romy,2019,FEMALE,0,0,0,13,13,449.0
Rosa,2019,FEMALE,0,0,0,14,14,424.0
Rose,2019,FEMALE,0,0,56,110,166,99.0
Rosie,2019,FEMALE,0,0,0,11,11,515.0
Royal,2019,FEMALE,0,10,0,0,10,569.0
Royalty,2019,FEMALE,0,15,0,0,15,401.0
Ruby,2019,FEMALE,33,0,51,171,255,64.0
Ruchel,2019,FEMALE,0,0,0,11,11,515.0
Ruchy,2019,FEMALE,0,0,0,27,27,266.0
Ruth,2019,FEMALE,0,0,0,16,16,380.0
Ryan,2019,FEMALE,0,15,0,0,15,401.0
Rylee,2019,FEMALE,0,40,22,0,62,181.0
Sabrina,2019,FEMALE,0,0,0,24,24,274.0
Sadie,2019,FEMALE,0,0,0,45,45,218.0
Sage,2019,FEMALE,0,14,0,0,14,424.0
Samantha,2019,FEMALE,0,0,142,44,186,87.0
Samara,2019,FEMALE,0,0,31,0,31,255.0
Samira,2019,FEMALE,0,0,0,11,11,515.0
Sanai,2019,FEMALE,0,10,0,0,10,569.0
Sapphire,2019,FEMALE,0,11,0,0,11,515.0
Sara,2019,FEMALE,48,0,42,414,504,36.0
Sarah,2019,FEMALE,152,60,156,672,1040,10.0
Sarai,2019,FEMALE,0,34,50,0,84,143.0
Sariyah,2019,FEMALE,0,10,0,0,10,569.0
Sasha,2019,FEMALE,0,0,0,23,23,284.0
Savannah,2019,FEMALE,0,72,87,51,210,78.0
Scarlet,2019,FEMALE,0,0,10,0,10,569.0
Scarlett,2019,FEMALE,51,0,255,159,465,38.0
Selena,2019,FEMALE,0,0,14,0,14,424.0
Selina,2019,FEMALE,10,0,0,0,10,569.0
Serafina,2019,FEMALE,0,0,0,10,10,569.0
Serena,2019,FEMALE,20,0,0,40,60,185.0
Serenity,2019,FEMALE,0,70,52,0,122,123.0
Sevyn,2019,FEMALE,0,10,0,0,10,569.0
Shaina,2019,FEMALE,0,0,0,12,12,477.0
Shaindel,2019,FEMALE,0,0,0,16,16,380.0
Shaindy,2019,FEMALE,0,0,0,45,45,218.0
Sherlyn,2019,FEMALE,0,0,10,0,10,569.0
Shevy,2019,FEMALE,0,0,0,14,14,424.0
Shifra,2019,FEMALE,0,0,0,11,11,515.0
Shiloh,2019,FEMALE,0,14,0,0,14,424.0
Shira,2019,FEMALE,0,0,0,11,11,515.0
Shoshana,2019,FEMALE,0,0,0,20,20,320.0
Siena,2019,FEMALE,0,0,0,22,22,292.0
Sienna,2019,FEMALE,0,51,54,159,264,61.0
Sima,2019,FEMALE,0,0,0,15,15,401.0
Simone,2019,FEMALE,0,0,0,20,20,320.0
Skyla,2019,FEMALE,0,0,10,0,10,569.0
Skylah,2019,FEMALE,0,12,0,0,12,477.0
Skylar,2019,FEMALE,44,200,80,100,424,43.0
Sloane,2019,FEMALE,0,0,0,35,35,244.0
Sofia,2019,FEMALE,72,0,345,348,765,17.0
Sophia,2019,FEMALE,284,108,772,616,1780,3.0
Sophie,2019,FEMALE,66,0,57,267,390,46.0
Stella,2019,FEMALE,45,0,39,174,258,63.0
Stephanie,2019,FEMALE,22,0,46,0,68,173.0
Summer,2019,FEMALE,0,57,42,51,150,105.0
Suri,2019,FEMALE,0,0,0,14,14,424.0
Sury,2019,FEMALE,0,0,0,40,40,233.0
Sydney,2019,FEMALE,0,0,0,20,20,320.0
Sylvia,2019,FEMALE,0,0,0,12,12,477.0
Sylvie,2019,FEMALE,0,0,0,13,13,449.0
Talia,2019,FEMALE,0,0,0,39,39,239.0
Taylor,2019,FEMALE,0,22,0,0,22,292.0
Tenzin,2019,FEMALE,24,0,0,0,24,274.0
Tessa,2019,FEMALE,0,0,0,10,10,569.0
Thea,2019,FEMALE,0,0,0,12,12,477.0
Tiffany,2019,FEMALE,0,0,10,0,10,569.0
Toby,2019,FEMALE,0,0,0,43,43,225.0
Tori,2019,FEMALE,0,11,0,0,11,515.0
Trinity,2019,FEMALE,0,13,0,0,13,449.0
Tzipora,2019,FEMALE,0,0,0,11,11,515.0
Tziporah,2019,FEMALE,0,0,0,13,13,449.0
Tzippy,2019,FEMALE,0,0,0,12,12,477.0
Valentina,2019,FEMALE,0,0,246,96,342,50.0
Valeria,2019,FEMALE,0,0,40,0,40,233.0
Valerie,2019,FEMALE,0,0,47,0,47,211.0
Valery,2019,FEMALE,0,0,17,0,17,365.0
Vanessa,2019,FEMALE,20,0,36,0,56,192.0
Vera,2019,FEMALE,0,0,0,31,31,255.0
Veronica,2019,FEMALE,0,0,0,19,19,336.0
Vicky,2019,FEMALE,10,0,0,0,10,569.0
Victoria,2019,FEMALE,0,57,312,240,609,26.0
Vienna,2019,FEMALE,0,0,0,13,13,449.0
Violet,2019,FEMALE,33,0,87,168,288,54.0
Vivian,2019,FEMALE,32,0,0,86,118,125.0
Vivienne,2019,FEMALE,0,0,0,21,21,306.0
Willa,2019,FEMALE,0,0,0,17,17,365.0
Willow,2019,FEMALE,0,0,0,14,14,424.0
Winnie,2019,FEMALE,0,0,0,11,11,515.0
Winter,2019,FEMALE,0,14,0,0,14,424.0
Wynter,2019,FEMALE,0,25,0,0,25,270.0
Ximena,2019,FEMALE,0,0,21,0,21,306.0
Yael,2019,FEMALE,0,0,0,22,22,292.0
Yareli,2019,FEMALE,0,0,10,0,10,569.0
Yaretzi,2019,FEMALE,0,0,17,0,17,365.0
Yaritza,2019,FEMALE,0,0,10,0,10,569.0
Yasmina,2019,FEMALE,0,0,0,12,12,477.0
Yehudis,2019,FEMALE,0,0,0,22,22,292.0
Yides,2019,FEMALE,0,0,0,34,34,250.0
Yitty,2019,FEMALE,0,0,0,36,36,241.0
Yocheved,2019,FEMALE,0,0,0,21,21,306.0
Zahra,2019,FEMALE,17,0,0,0,17,365.0
Zainab,2019,FEMALE,44,26,0,0,70,168.0
Zara,2019,FEMALE,76,44,64,44,228,70.0
Zariah,2019,FEMALE,0,10,0,0,10,569.0
Zelda,2019,FEMALE,0,0,0,13,13,449.0
Zhuri,2019,FEMALE,0,10,0,0,10,569.0
Zissy,2019,FEMALE,0,0,0,21,21,306.0
Zoe,2019,FEMALE,132,92,364,372,960,12.0
Zoey,2019,FEMALE,96,140,132,80,448,40.0
Zora,2019,FEMALE,0,11,0,0,11,515.0
Zoya,2019,FEMALE,12,0,0,0,12,477.0
Zuri,2019,FEMALE,0,78,24,0,102,130.0
Aahil,2019,MALE,10,0,0,0,10,535.0
Aarav,2019,MALE,12,0,0,0,12,466.0
Aaron,2019,MALE,180,136,396,264,976,24.0
Aayan,2019,MALE,14,0,0,0,14,414.0
Abdiel,2019,MALE,0,0,29,0,29,269.0
Abdoulaye,2019,MALE,0,15,0,0,15,396.0
Abdullah,2019,MALE,38,0,0,0,38,249.0
Abdulloh,2019,MALE,0,0,0,15,15,396.0
Abel,2019,MALE,0,0,15,0,15,396.0
Abraham,2019,MALE,0,0,46,282,328,80.0
Abrar,2019,MALE,15,0,0,0,15,396.0
Abubakr,2019,MALE,0,0,0,11,11,494.0
Ace,2019,MALE,0,28,22,0,50,222.0
Adam,2019,MALE,152,52,104,536,844,30.0
Adiel,2019,MALE,0,0,10,0,10,535.0
Adonis,2019,MALE,0,80,52,0,132,145.0
Adrian,2019,MALE,96,68,372,180,716,39.0
Adriel,2019,MALE,0,0,41,0,41,241.0
Ahad,2019,MALE,10,0,0,0,10,535.0
Aharon,2019,MALE,0,0,0,19,19,335.0
Ahmad,2019,MALE,10,0,0,0,10,535.0
Ahmed,2019,MALE,42,30,0,87,159,124.0
Ahnaf,2019,MALE,10,0,0,0,10,535.0
Ahron,2019,MALE,0,0,0,13,13,438.0
Aidan,2019,MALE,42,0,42,108,192,107.0
Aiden,2019,MALE,588,284,552,272,1696,6.0
Akiva,2019,MALE,0,0,0,27,27,277.0
Alan,2019,MALE,54,0,123,54,231,98.0
Albert,2019,MALE,24,0,0,46,70,197.0
Alejandro,2019,MALE,0,0,40,0,40,243.0
Alessandro,2019,MALE,0,0,11,0,11,494.0
Alex,2019,MALE,96,52,144,92,384,69.0
Alexander,2019,MALE,212,108,456,672,1448,13.0
Alexis,2019,MALE,0,0,19,0,19,335.0
Ali,2019,MALE,44,0,0,94,138,138.0
Allan,2019,MALE,0,0,10,0,10,535.0
Allen,2019,MALE,15,0,0,0,15,396.0
Alonso,2019,MALE,0,0,12,0,12,466.0
Alpha,2019,MALE,0,12,0,0,12,466.0
Alston,2019,MALE,12,0,0,0,12,466.0
Alvin,2019,MALE,24,0,0,0,24,292.0
Amadou,2019,MALE,0,12,0,0,12,466.0
Amari,2019,MALE,0,112,26,0,138,138.0
Amir,2019,MALE,40,404,144,148,736,38.0
Amrom,2019,MALE,0,0,0,10,10,535.0
Anderson,2019,MALE,11,0,0,0,11,494.0
Andre,2019,MALE,0,10,0,0,10,535.0
Andres,2019,MALE,0,0,31,0,31,263.0
Andrew,2019,MALE,156,68,196,236,656,43.0
Andy,2019,MALE,46,0,28,0,74,192.0
Angel,2019,MALE,0,0,117,0,117,156.0
Angelo,2019,MALE,0,0,30,30,60,203.0
Anson,2019,MALE,13,0,0,0,13,438.0
Anthony,2019,MALE,80,116,304,320,820,34.0
Antonio,2019,MALE,0,0,32,42,74,192.0
Archer,2019,MALE,0,0,0,14,14,414.0
Arham,2019,MALE,42,0,0,0,42,239.0
Ari,2019,MALE,0,0,0,47,47,232.0
Ariel,2019,MALE,0,0,36,66,102,165.0
Arjun,2019,MALE,14,0,0,0,14,414.0
Arlo,2019,MALE,0,0,0,21,21,310.0
Aron,2019,MALE,0,0,0,79,79,187.0
Arthur,2019,MALE,32,0,0,90,122,153.0
Aryan,2019,MALE,18,0,0,0,18,351.0
Aryeh,2019,MALE,0,0,0,31,31,263.0
Asher,2019,MALE,56,72,112,364,604,46.0
Ashton,2019,MALE,44,124,72,48,288,88.0
August,2019,MALE,0,0,28,64,92,176.0
Austin,2019,MALE,184,80,184,96,544,53.0
Avery,2019,MALE,0,60,66,30,156,125.0
Avi,2019,MALE,0,0,0,15,15,396.0
Avraham,2019,MALE,0,0,0,52,52,215.0
Avrohom,2019,MALE,0,0,0,23,23,299.0
Avrum,2019,MALE,0,0,0,13,13,438.0
Axel,2019,MALE,0,0,158,28,186,113.0
Ayaan,2019,MALE,57,0,0,0,57,206.0
Ayan,2019,MALE,15,0,0,0,15,396.0
Ayden,2019,MALE,120,128,256,40,544,53.0
Beau,2019,MALE,0,0,0,21,21,310.0
Ben,2019,MALE,0,0,0,24,24,292.0
Benjamin,2019,MALE,144,72,264,728,1208,19.0
Bennett,2019,MALE,0,0,0,13,13,438.0
Benzion,2019,MALE,0,0,0,23,23,299.0
Berl,2019,MALE,0,0,0,16,16,377.0
Binyamin,2019,MALE,0,0,0,11,11,494.0
Binyomin,2019,MALE,0,0,0,17,17,359.0
Blake,2019,MALE,0,0,0,19,19,335.0
Bodhi,2019,MALE,20,0,0,30,50,222.0
Boubacar,2019,MALE,0,11,0,0,11,494.0
Bradley,2019,MALE,0,0,22,24,46,235.0
Brandon,2019,MALE,76,48,116,48,288,88.0
Brayden,2019,MALE,0,0,0,14,14,414.0
Brian,2019,MALE,60,0,57,36,153,130.0
Brody,2019,MALE,0,0,0,23,23,299.0
Brooks,2019,MALE,0,0,0,21,21,310.0
Bryan,2019,MALE,42,33,63,0,138,138.0
Bryce,2019,MALE,0,51,45,42,138,138.0
Bryson,2019,MALE,0,94,48,0,142,136.0
Byron,2019,MALE,0,0,10,0,10,535.0
Caden,2019,MALE,0,10,0,0,10,535.0
Caiden,2019,MALE,0,15,0,0,15,396.0
Cairo,2019,MALE,0,84,28,0,112,159.0
Caleb,2019,MALE,104,124,184,140,552,52.0
Calvin,2019,MALE,0,0,0,13,13,438.0
Cameron,2019,MALE,0,117,48,126,291,87.0
Carlos,2019,MALE,0,0,48,0,48,226.0
Carter,2019,MALE,0,183,54,84,321,81.0
Cayden,2019,MALE,0,14,0,0,14,414.0
Cesar,2019,MALE,0,0,19,0,19,335.0
Chaim,2019,MALE,0,0,0,138,138,138.0
Chance,2019,MALE,0,17,0,0,17,359.0
Charles,2019,MALE,54,0,33,444,531,56.0
Charlie,2019,MALE,0,0,0,25,25,287.0
Chase,2019,MALE,0,114,60,63,237,95.0
Cheskel,2019,MALE,0,0,0,20,20,325.0
Chesky,2019,MALE,0,0,0,15,15,396.0
Chris,2019,MALE,20,0,32,0,52,215.0
Christian,2019,MALE,44,180,280,168,672,42.0
Christopher,2019,MALE,84,104,284,240,712,40.0
Cody,2019,MALE,15,0,0,0,15,396.0
Cole,2019,MALE,0,0,0,22,22,305.0
Colin,2019,MALE,0,0,0,22,22,305.0
Connor,2019,MALE,26,0,0,64,90,178.0
Cooper,2019,MALE,0,0,0,28,28,272.0
Cristian,2019,MALE,0,0,22,0,22,305.0
Cyrus,2019,MALE,0,0,0,12,12,466.0
Dallas,2019,MALE,0,10,0,0,10,535.0
Damian,2019,MALE,0,0,94,32,126,151.0
Damien,2019,MALE,0,0,10,0,10,535.0
Daniel,2019,MALE,292,176,512,696,1676,7.0
Dante,2019,MALE,0,0,20,0,20,325.0
Dariel,2019,MALE,0,0,27,0,27,277.0
Darren,2019,MALE,15,0,0,0,15,396.0
David,2019,MALE,64,156,420,1008,1648,9.0
Dean,2019,MALE,0,0,0,28,28,272.0
Declan,2019,MALE,0,0,0,26,26,284.0
Derek,2019,MALE,28,0,44,0,72,194.0
Desmond,2019,MALE,0,0,0,11,11,494.0
Devin,2019,MALE,0,0,0,10,10,535.0
Diego,2019,MALE,0,0,50,0,50,222.0
Dion,2019,MALE,0,0,0,10,10,535.0
Dominic,2019,MALE,0,0,52,54,106,164.0
Dov,2019,MALE,0,0,0,47,47,232.0
Dovid,2019,MALE,0,0,0,39,39,246.0
Duvid,2019,MALE,0,0,0,11,11,494.0
Dylan,2019,MALE,168,104,848,352,1472,12.0
Ean,2019,MALE,0,0,17,0,17,359.0
Eason,2019,MALE,21,0,0,0,21,310.0
Eden,2019,MALE,36,0,0,20,56,209.0
Edgar,2019,MALE,0,0,10,0,10,535.0
Edison,2019,MALE,10,0,0,0,10,535.0
Eduardo,2019,MALE,0,0,14,0,14,414.0
Edward,2019,MALE,0,0,50,60,110,161.0
Edwin,2019,MALE,0,0,18,0,18,351.0
Efraim,2019,MALE,0,0,0,16,16,377.0
Eitan,2019,MALE,0,0,0,19,19,335.0
Eli,2019,MALE,0,54,105,273,432,64.0
Eliam,2019,MALE,0,0,16,0,16,377.0
Elian,2019,MALE,0,0,46,0,46,235.0
Elias,2019,MALE,44,104,372,132,652,44.0
Eliel,2019,MALE,0,0,21,0,21,310.0
Eliezer,2019,MALE,0,0,0,29,29,269.0
Elijah,2019,MALE,68,328,348,80,824,32.0
Elimelech,2019,MALE,0,0,0,17,17,359.0
Eliyahu,2019,MALE,0,0,0,33,33,260.0
Elliot,2019,MALE,30,0,33,141,204,105.0
Elliott,2019,MALE,0,0,0,26,26,284.0
Ellis,2019,MALE,0,0,0,12,12,466.0
Elya,2019,MALE,0,0,0,15,15,396.0
Emanuel,2019,MALE,0,0,15,0,15,396.0
Emerson,2019,MALE,0,0,0,11,11,494.0
Emiliano,2019,MALE,0,0,22,0,22,305.0
Emilio,2019,MALE,0,0,31,0,31,263.0
Emmanuel,2019,MALE,0,60,102,0,162,123.0
Emmett,2019,MALE,0,0,0,20,20,325.0
Enzo,2019,MALE,36,0,81,36,153,130.0
Eric,2019,MALE,164,40,56,48,308,84.0
Erick,2019,MALE,0,0,40,0,40,243.0
Ermias,2019,MALE,0,20,24,0,44,237.0
Ethan,2019,MALE,616,276,780,452,2124,3.0
Evan,2019,MALE,224,40,184,136,584,50.0
Everett,2019,MALE,0,0,0,27,27,277.0
Ezekiel,2019,MALE,0,32,44,0,76,189.0
Ezequiel,2019,MALE,0,0,16,0,16,377.0
Ezra,2019,MALE,0,57,69,222,348,76.0
Ezriel,2019,MALE,0,0,0,10,10,535.0
Farhan,2019,MALE,12,0,0,0,12,466.0
Felipe,2019,MALE,0,0,11,0,11,494.0
Felix,2019,MALE,36,0,30,81,147,132.0
Fernando,2019,MALE,0,0,12,0,12,466.0
Finn,2019,MALE,0,0,0,28,28,272.0
Fishel,2019,MALE,0,0,0,10,10,535.0
Francesco,2019,MALE,0,0,0,11,11,494.0
Francis,2019,MALE,0,0,0,13,13,438.0
Francisco,2019,MALE,0,0,20,0,20,325.0
Frank,2019,MALE,0,0,0,21,21,310.0
Frederick,2019,MALE,0,0,0,13,13,438.0
Gabriel,2019,MALE,60,104,388,420,972,25.0
Gael,2019,MALE,0,0,112,0,112,159.0
Gavin,2019,MALE,54,0,36,78,168,119.0
Gavriel,2019,MALE,0,0,0,18,18,351.0
George,2019,MALE,81,0,45,222,348,76.0
Gianni,2019,MALE,0,0,11,0,11,494.0
Giovanni,2019,MALE,0,0,36,50,86,183.0
Graham,2019,MALE,0,0,0,18,18,351.0
Grant,2019,MALE,0,0,0,19,19,335.0
Grayson,2019,MALE,56,48,164,76,344,78.0
Gregory,2019,MALE,0,0,0,12,12,466.0
Grey,2019,MALE,0,0,0,10,10,535.0
Greyson,2019,MALE,0,0,82,46,128,148.0
Griffin,2019,MALE,0,0,0,15,15,396.0
Guy,2019,MALE,0,0,0,11,11,494.0
Hamza,2019,MALE,28,0,0,24,52,215.0
Harrison,2019,MALE,0,0,0,38,38,249.0
Harry,2019,MALE,0,0,0,21,21,310.0
Hassan,2019,MALE,0,13,0,0,13,438.0
Hayden,2019,MALE,30,30,0,36,96,175.0
Hector,2019,MALE,0,0,20,0,20,325.0
Henry,2019,MALE,144,0,75,525,744,36.0
Hersh,2019,MALE,0,0,0,22,22,305.0
Hershel,2019,MALE,0,0,0,21,21,310.0
Hershy,2019,MALE,0,0,0,28,28,272.0
Hillel,2019,MALE,0,0,0,15,15,396.0
Hudson,2019,MALE,38,0,0,90,128,148.0
Hugo,2019,MALE,20,0,0,40,60,203.0
Hunter,2019,MALE,80,124,104,120,428,66.0
Ian,2019,MALE,111,0,306,39,456,61.0
Ibrahim,2019,MALE,117,108,0,72,297,86.0
Ibrahima,2019,MALE,0,12,0,0,12,466.0
Ibrohim,2019,MALE,0,0,0,13,13,438.0
Idris,2019,MALE,0,0,0,11,11,494.0
Iker,2019,MALE,0,0,24,0,24,292.0
Imran,2019,MALE,0,0,0,13,13,438.0
Isaac,2019,MALE,68,72,440,528,1108,20.0
Isaiah,2019,MALE,0,72,96,0,168,119.0
Isaias,2019,MALE,0,0,21,0,21,310.0
Ishaan,2019,MALE,10,0,0,0,10,535.0
Ismael,2019,MALE,0,20,52,0,72,194.0
Israel,2019,MALE,0,51,72,51,174,117.0
Ivan,2019,MALE,60,0,90,39,189,109.0
Jace,2019,MALE,0,102,123,48,273,90.0
Jack,2019,MALE,63,0,66,612,741,37.0
Jackson,2019,MALE,92,48,60,276,476,59.0
Jacob,2019,MALE,124,116,836,852,1928,4.0
Jad,2019,MALE,0,0,0,14,14,414.0
Jaden,2019,MALE,54,63,39,0,156,125.0
Jadiel,2019,MALE,0,0,33,0,33,260.0
Jael,2019,MALE,0,0,11,0,11,494.0
Jaiden,2019,MALE,0,24,24,0,48,226.0
Jake,2019,MALE,33,0,84,72,189,109.0
Jakob,2019,MALE,0,0,0,10,10,535.0
James,2019,MALE,148,64,264,832,1308,16.0
Jameson,2019,MALE,0,0,0,19,19,335.0
Jamie,2019,MALE,0,0,0,12,12,466.0
Jamir,2019,MALE,0,10,0,0,10,535.0
Jared,2019,MALE,0,0,16,0,16,377.0
Jariel,2019,MALE,0,0,14,0,14,414.0
Jasiah,2019,MALE,0,14,0,0,14,414.0
Jason,2019,MALE,208,84,220,92,604,46.0
Jasper,2019,MALE,214,0,0,42,256,93.0
Javier,2019,MALE,0,0,27,0,27,277.0
Jaxon,2019,MALE,0,75,90,60,225,99.0
Jaxson,2019,MALE,0,45,78,42,165,121.0
Jay,2019,MALE,0,0,14,0,14,414.0
Jayce,2019,MALE,0,68,74,0,142,136.0
Jayceon,2019,MALE,0,13,0,0,13,438.0
Jaycob,2019,MALE,0,0,14,0,14,414.0
Jayden,2019,MALE,472,276,688,64,1500,11.0
Jaylen,2019,MALE,0,20,20,0,40,243.0
Jayson,2019,MALE,0,0,17,0,17,359.0
Jaziel,2019,MALE,0,0,11,0,11,494.0
Jefferson,2019,MALE,0,0,11,0,11,494.0
Jeffrey,2019,MALE,14,0,0,0,14,414.0
Jeremiah,2019,MALE,0,118,148,0,266,91.0
Jeremy,2019,MALE,54,0,124,0,178,115.0
Jesse,2019,MALE,0,28,0,28,56,209.0
Jesus,2019,MALE,0,0,37,0,37,254.0
Jimmy,2019,MALE,11,0,0,0,11,494.0
Joaquin,2019,MALE,0,0,14,0,14,414.0
Joel,2019,MALE,0,51,87,78,216,100.0
Johan,2019,MALE,0,0,17,0,17,359.0
John,2019,MALE,52,64,176,576,868,28.0
Johnny,2019,MALE,0,0,10,0,10,535.0
Jonah,2019,MALE,0,48,63,138,249,94.0
Jonas,2019,MALE,0,0,16,0,16,377.0
Jonathan,2019,MALE,116,112,268,208,704,41.0
Jordan,2019,MALE,40,108,132,168,448,63.0
Jorge,2019,MALE,0,0,20,0,20,325.0
Jose,2019,MALE,0,0,48,0,48,226.0
Joseph,2019,MALE,88,56,312,932,1388,14.0
Joshua,2019,MALE,84,212,376,180,852,29.0
Josiah,2019,MALE,0,144,162,0,306,85.0
Josue,2019,MALE,0,0,52,0,52,215.0
Juan,2019,MALE,0,0,48,0,48,226.0
Judah,2019,MALE,0,0,0,31,31,263.0
Jude,2019,MALE,0,0,0,30,30,268.0
Julian,2019,MALE,88,48,304,360,800,35.0
Julien,2019,MALE,0,0,0,13,13,438.0
Julius,2019,MALE,0,0,18,0,18,351.0
Justice,2019,MALE,0,17,0,0,17,359.0
Justin,2019,MALE,164,88,216,100,568,51.0
Kabir,2019,MALE,12,0,0,0,12,466.0
Kaden,2019,MALE,0,10,0,0,10,535.0
Kai,2019,MALE,120,96,64,80,360,73.0
Kaiden,2019,MALE,0,80,54,0,134,144.0
Kairo,2019,MALE,0,104,24,0,128,148.0
Kaleb,2019,MALE,30,60,66,0,156,125.0
Kamari,2019,MALE,0,17,0,0,17,359.0
Karter,2019,MALE,0,80,20,0,100,169.0
Kayden,2019,MALE,63,159,180,0,402,67.0
Kelvin,2019,MALE,0,0,15,0,15,396.0
Kendrick,2019,MALE,0,0,12,0,12,466.0
Kenneth,2019,MALE,20,0,46,0,66,201.0
Kenny,2019,MALE,0,0,10,0,10,535.0
Kenzo,2019,MALE,0,26,0,0,26,284.0
Kevin,2019,MALE,120,64,192,80,456,61.0
Khalil,2019,MALE,0,14,0,0,14,414.0
Kieran,2019,MALE,0,0,0,16,16,377.0
King,2019,MALE,0,146,42,0,188,112.0
Kingsley,2019,MALE,14,0,0,0,14,414.0
Kyle,2019,MALE,138,39,0,39,216,100.0
Kyrie,2019,MALE,0,106,24,0,130,146.0
Kyro,2019,MALE,0,11,0,0,11,494.0
Laith,2019,MALE,0,0,0,11,11,494.0
Landon,2019,MALE,44,48,76,68,236,96.0
Lazer,2019,MALE,0,0,0,25,25,287.0
Leandro,2019,MALE,0,0,12,0,12,466.0
Legend,2019,MALE,0,106,38,0,144,134.0
Leo,2019,MALE,174,0,144,504,822,33.0
Leon,2019,MALE,100,40,72,160,372,72.0
Leonard,2019,MALE,0,0,0,10,10,535.0
Leonardo,2019,MALE,0,0,116,98,214,103.0
Leonel,2019,MALE,0,0,13,0,13,438.0
Lev,2019,MALE,0,0,0,21,21,310.0
Levi,2019,MALE,52,92,80,264,488,57.0
Liam,2019,MALE,320,388,1692,572,2972,1.0
Lincoln,2019,MALE,0,0,0,11,11,494.0
Lipa,2019,MALE,0,0,0,37,37,254.0
Logan,2019,MALE,140,168,464,240,1012,22.0
Lorenzo,2019,MALE,0,0,70,66,136,143.0
Louis,2019,MALE,26,0,0,72,98,172.0
Luca,2019,MALE,54,0,99,333,486,58.0
Lucas,2019,MALE,612,60,704,436,1812,5.0
Luis,2019,MALE,0,0,75,0,75,191.0
Luka,2019,MALE,0,0,0,21,21,310.0
Lukas,2019,MALE,0,0,52,30,82,184.0
Luke,2019,MALE,66,0,42,243,351,75.0
Maison,2019,MALE,0,0,11,0,11,494.0
Major,2019,MALE,0,13,0,0,13,438.0
Makai,2019,MALE,0,13,0,0,13,438.0
Malachi,2019,MALE,0,27,0,0,27,277.0
Malcolm,2019,MALE,0,0,0,13,13,438.0
Malek,2019,MALE,0,0,0,12,12,466.0
Malik,2019,MALE,0,17,0,0,17,359.0
Mamadou,2019,MALE,0,21,0,0,21,310.0
Manuel,2019,MALE,0,0,20,0,20,325.0
Marco,2019,MALE,0,0,22,28,50,222.0
Marcos,2019,MALE,0,0,11,0,11,494.0
Marcus,2019,MALE,23,0,0,0,23,299.0
Mark,2019,MALE,0,0,0,51,51,220.0
Martin,2019,MALE,0,0,28,40,68,198.0
Mason,2019,MALE,260,336,516,244,1356,15.0
Mateo,2019,MALE,0,0,294,50,344,78.0
Mathias,2019,MALE,0,0,19,0,19,335.0
Matias,2019,MALE,0,0,51,0,51,220.0
Matteo,2019,MALE,0,0,86,70,156,125.0
Matthew,2019,MALE,160,96,968,388,1612,10.0
Max,2019,MALE,78,0,57,249,384,69.0
Maxim,2019,MALE,0,0,0,17,17,359.0
Maximilian,2019,MALE,0,0,0,19,19,335.0
Maximiliano,2019,MALE,0,0,16,0,16,377.0
Maximus,2019,MALE,0,0,32,36,68,198.0
Maxwell,2019,MALE,28,0,0,102,130,146.0
Mayer,2019,MALE,0,0,0,18,18,351.0
Md,2019,MALE,16,0,0,0,16,377.0
Meilech,2019,MALE,0,0,0,11,11,494.0
Meir,2019,MALE,0,0,0,67,67,200.0
Mekhi,2019,MALE,0,14,0,0,14,414.0
Menachem,2019,MALE,0,0,0,79,79,187.0
Menashe,2019,MALE,0,0,0,11,11,494.0
Mendel,2019,MALE,0,0,0,38,38,249.0
Mendy,2019,MALE,0,0,0,25,25,287.0
Messiah,2019,MALE,0,108,48,0,156,125.0
Micah,2019,MALE,0,78,33,36,147,132.0
Michael,2019,MALE,68,204,456,932,1660,8.0
Miguel,2019,MALE,0,0,32,0,32,262.0
Milan,2019,MALE,0,0,24,0,24,292.0
Miles,2019,MALE,52,56,108,376,592,49.0
Milo,2019,MALE,0,0,34,68,102,165.0
Mohamed,2019,MALE,0,92,0,88,180,114.0
Mohammad,2019,MALE,47,0,0,0,47,232.0
Mohammed,2019,MALE,66,33,0,45,144,134.0
Moises,2019,MALE,0,0,16,0,16,377.0
Moishe,2019,MALE,0,0,0,13,13,438.0
Moishy,2019,MALE,0,0,0,12,12,466.0
Mordechai,2019,MALE,0,0,0,117,117,156.0
Morris,2019,MALE,0,0,0,16,16,377.0
Moses,2019,MALE,0,0,0,19,19,335.0
Moshe,2019,MALE,0,0,0,232,232,97.0
Mouhamed,2019,MALE,0,11,0,0,11,494.0
Moussa,2019,MALE,0,11,0,0,11,494.0
Muhammad,2019,MALE,429,57,0,117,603,48.0
Muhammad Ali,2019,MALE,0,0,0,11,11,494.0
Musa,2019,MALE,16,0,0,0,16,377.0
Myles,2019,MALE,0,54,30,33,117,156.0
Nachman,2019,MALE,0,0,0,10,10,535.0
Naftali,2019,MALE,0,0,0,27,27,277.0
Naftuli,2019,MALE,0,0,0,25,25,287.0
Nasir,2019,MALE,0,38,0,0,38,249.0
Nathan,2019,MALE,220,76,220,320,836,31.0
Nathaniel,2019,MALE,72,76,124,188,460,60.0
Neil,2019,MALE,28,0,0,20,48,226.0
Nicholas,2019,MALE,108,108,292,384,892,26.0
Nico,2019,MALE,0,0,0,24,24,292.0
Nicolas,2019,MALE,0,0,114,50,164,122.0
Noach,2019,MALE,0,0,0,10,10,535.0
Noah,2019,MALE,276,540,1048,756,2620,2.0
Noam,2019,MALE,0,0,0,18,18,351.0
Noel,2019,MALE,0,0,25,0,25,287.0
Nolan,2019,MALE,56,72,76,116,320,82.0
Oliver,2019,MALE,153,0,297,438,888,27.0
Omar,2019,MALE,48,60,40,164,312,83.0
Omari,2019,MALE,0,15,0,0,15,396.0
Orion,2019,MALE,0,22,0,20,42,239.0
Oscar,2019,MALE,42,0,45,120,207,104.0
Oskar,2019,MALE,0,0,0,11,11,494.0
Otis,2019,MALE,0,0,0,10,10,535.0
Otto,2019,MALE,0,0,0,14,14,414.0
Oumar,2019,MALE,0,13,0,0,13,438.0
Owen,2019,MALE,99,0,57,228,384,69.0
Pablo,2019,MALE,0,0,16,0,16,377.0
Parker,2019,MALE,0,0,0,24,24,292.0
Patrick,2019,MALE,20,0,0,62,82,184.0
Paul,2019,MALE,0,0,0,19,19,335.0
Pedro,2019,MALE,0,0,13,0,13,438.0
Peter,2019,MALE,0,0,26,72,98,172.0
Philip,2019,MALE,0,0,0,19,19,335.0
Pierce,2019,MALE,0,0,0,14,14,414.0
Pinchas,2019,MALE,0,0,0,11,11,494.0
Pinchus,2019,MALE,0,0,0,17,17,359.0
Preston,2019,MALE,24,28,0,0,52,215.0
Prince,2019,MALE,0,52,40,0,92,176.0
Quincy,2019,MALE,0,12,0,0,12,466.0
Rafael,2019,MALE,0,0,44,80,124,152.0
Ralph,2019,MALE,0,0,0,10,10,535.0
Randy,2019,MALE,0,0,11,0,11,494.0
Raphael,2019,MALE,0,22,0,54,76,189.0
Rayan,2019,MALE,54,0,0,34,88,180.0
Raymond,2019,MALE,30,0,33,39,102,165.0
Rayyan,2019,MALE,11,0,0,0,11,494.0
Reid,2019,MALE,0,0,0,13,13,438.0
Remy,2019,MALE,0,0,0,17,17,359.0
Reuven,2019,MALE,0,0,0,12,12,466.0
Rhys,2019,MALE,0,0,0,11,11,494.0
Ricardo,2019,MALE,0,0,13,0,13,438.0
Richard,2019,MALE,0,33,33,54,120,155.0
River,2019,MALE,0,0,0,20,20,325.0
Robert,2019,MALE,0,0,54,138,192,107.0
Roberto,2019,MALE,0,0,11,0,11,494.0
Rocco,2019,MALE,0,0,0,12,12,466.0
Rohaan,2019,MALE,10,0,0,0,10,535.0
Roman,2019,MALE,0,48,57,93,198,106.0
Ronan,2019,MALE,0,0,0,21,21,310.0
Rory,2019,MALE,0,0,0,12,12,466.0
Rowan,2019,MALE,0,0,0,21,21,310.0
Royal,2019,MALE,0,17,0,0,17,359.0
Royce,2019,MALE,0,14,0,0,14,414.0
Ryan,2019,MALE,440,188,332,308,1268,18.0
Ryder,2019,MALE,20,0,0,36,56,209.0
Safwan,2019,MALE,11,0,0,0,11,494.0
Saifan,2019,MALE,11,0,0,0,11,494.0
Saint,2019,MALE,0,14,0,0,14,414.0
Salvatore,2019,MALE,0,0,0,28,28,272.0
Sam,2019,MALE,0,0,0,34,34,258.0
Samir,2019,MALE,0,0,12,0,12,466.0
Samuel,2019,MALE,72,132,320,580,1104,21.0
Santiago,2019,MALE,0,0,55,0,55,213.0
Santino,2019,MALE,0,0,0,16,16,377.0
Saul,2019,MALE,0,0,17,0,17,359.0
Scott,2019,MALE,0,0,0,11,11,494.0
Sean,2019,MALE,36,0,30,33,99,171.0
Sebastian,2019,MALE,40,96,860,296,1292,17.0
Selim,2019,MALE,0,0,0,13,13,438.0
Shalom,2019,MALE,0,0,0,20,20,325.0
Shane,2019,MALE,0,0,0,11,11,494.0
Shaul,2019,MALE,0,0,0,16,16,377.0
Shaya,2019,MALE,0,0,0,56,56,209.0
Shayan,2019,MALE,15,0,0,0,15,396.0
Shea,2019,MALE,0,0,0,17,17,359.0
Shia,2019,MALE,0,0,0,31,31,263.0
Shiloh,2019,MALE,0,16,0,0,16,377.0
Shimon,2019,MALE,0,0,0,102,102,165.0
Shloime,2019,MALE,0,0,0,19,19,335.0
Shloimy,2019,MALE,0,0,0,24,24,292.0
Shloma,2019,MALE,0,0,0,19,19,335.0
Shlome,2019,MALE,0,0,0,21,21,310.0
Shlomo,2019,MALE,0,0,0,71,71,196.0
Shmiel,2019,MALE,0,0,0,29,29,269.0
Shmuel,2019,MALE,0,0,0,61,61,202.0
Sholom,2019,MALE,0,0,0,16,16,377.0
Shulem,2019,MALE,0,0,0,43,43,238.0
Simcha,2019,MALE,0,0,0,39,39,246.0
Simon,2019,MALE,0,0,0,39,39,246.0
Sincere,2019,MALE,0,16,0,0,16,377.0
Solomon,2019,MALE,0,0,0,48,48,226.0
Sonny,2019,MALE,0,0,0,17,17,359.0
Spencer,2019,MALE,0,0,0,13,13,438.0
Stephen,2019,MALE,0,0,0,12,12,466.0
Steven,2019,MALE,42,0,144,75,261,92.0
Syed,2019,MALE,14,0,0,0,14,414.0
Tenzin,2019,MALE,36,0,0,0,36,257.0
Theo,2019,MALE,26,0,0,84,110,161.0
Theodore,2019,MALE,96,0,57,468,621,45.0
Thiago,2019,MALE,0,0,87,0,87,182.0
Thierno,2019,MALE,0,14,0,0,14,414.0
Thomas,2019,MALE,44,44,76,368,532,55.0
Timothy,2019,MALE,0,0,0,11,11,494.0
Tomas,2019,MALE,0,0,0,10,10,535.0
Travis,2019,MALE,10,0,0,0,10,535.0
Tristan,2019,MALE,48,68,60,40,216,100.0
Tyler,2019,MALE,80,124,76,76,356,74.0
Tzvi,2019,MALE,0,0,0,57,57,206.0
Uriel,2019,MALE,0,0,17,0,17,359.0
Usher,2019,MALE,0,0,0,34,34,258.0
Valentin,2019,MALE,0,0,11,0,11,494.0
Valentino,2019,MALE,0,0,13,0,13,438.0
Victor,2019,MALE,0,0,50,50,100,169.0
Vihaan,2019,MALE,12,0,0,0,12,466.0
Viktor,2019,MALE,0,0,0,10,10,535.0
Vincent,2019,MALE,50,0,0,72,122,153.0
Walter,2019,MALE,0,0,0,10,10,535.0
Wesley,2019,MALE,51,0,57,66,174,117.0
Weston,2019,MALE,0,0,0,10,10,535.0
William,2019,MALE,232,76,148,532,988,23.0
Wilson,2019,MALE,0,0,10,0,10,535.0
Winston,2019,MALE,19,0,0,0,19,335.0
Wyatt,2019,MALE,0,0,0,38,38,249.0
Xander,2019,MALE,0,0,10,0,10,535.0
Xavier,2019,MALE,56,108,176,52,392,68.0
Yaakov,2019,MALE,0,0,0,41,41,241.0
Yadiel,2019,MALE,0,0,16,0,16,377.0
Yakov,2019,MALE,0,0,0,57,57,206.0
Yariel,2019,MALE,0,0,10,0,10,535.0
Yechiel,2019,MALE,0,0,0,37,37,254.0
Yehoshua,2019,MALE,0,0,0,23,23,299.0
Yehuda,2019,MALE,0,0,0,89,89,179.0
Yeshaya,2019,MALE,0,0,0,10,10,535.0
Yida,2019,MALE,0,0,0,13,13,438.0
Yidel,2019,MALE,0,0,0,11,11,494.0
Yisrael,2019,MALE,0,0,0,19,19,335.0
Yisroel,2019,MALE,0,0,0,88,88,180.0
Yitzchak,2019,MALE,0,0,0,14,14,414.0
Yitzchok,2019,MALE,0,0,0,97,97,174.0
Yoel,2019,MALE,0,0,0,23,23,299.0
Yonah,2019,MALE,0,0,0,13,13,438.0
Yonatan,2019,MALE,0,0,0,13,13,438.0
Yosef,2019,MALE,0,0,0,109,109,163.0
Yossi,2019,MALE,0,0,0,14,14,414.0
Younis,2019,MALE,0,0,0,11,11,494.0
Yousef,2019,MALE,0,0,0,17,17,359.0
Youssef,2019,MALE,0,0,0,18,18,351.0
Yusuf,2019,MALE,66,48,0,75,189,109.0
Zachary,2019,MALE,72,48,60,252,432,64.0
Zaid,2019,MALE,0,0,12,0,12,466.0
Zain,2019,MALE,28,0,0,30,58,205.0
Zaire,2019,MALE,0,20,0,0,20,325.0
Zalmen,2019,MALE,0,0,0,12,12,466.0
Zane,2019,MALE,0,12,0,0,12,466.0
Zayan,2019,MALE,27,0,0,0,27,277.0
Zayden,2019,MALE,0,0,13,0,13,438.0
Zayn,2019,MALE,54,0,0,26,80,186.0
Zev,2019,MALE,0,0,0,55,55,213.0
Zion,2019,MALE,0,120,58,0,178,115.0
Zyaire,2019,MALE,0,12,0,0,12,466.0
